(actor)--[movie#@year]-->(actor)--...
Robert Downey Jr. -> 1969 -> 1969
1969 -> A Guide to Recognizing Your Saints -> A Guide to Recognizing Your Saints
A Guide to Recognizing Your Saints -> A Scanner Darkly -> A Scanner Darkly
Captain America: Civil War -> Captain America: Civil War -> Captain America: Civil War
Chances Are -> Chances Are -> Chances Are
Chaplin -> Chaplin -> Eros
Eros -> Eros -> I Am Steve McQueen
I Am Steve McQueen -> Only You -> Only You
Only You -> Restoration -> Restoration
Sherlock Holmes -> Sherlock Holmes -> Sherlock Holmes
Spider-Man: Homecoming -> Spider-Man: Homecoming -> The Avengers
The Gingerbread Man -> The Gingerbread Man -> The Gingerbread Man
The Judge -> The Singing Detective -> The Singing Detective
The Singing Detective -> Tropic Thunder -> Tropic Thunder
Tropic Thunder -> Two Girls and a Guy -> Two Girls and a Guy
Two Girls and a Guy -> Zodiac -> Zodiac
Kiefer Sutherland -> Chicago Joe and the Showgirl -> Chicago Joe and the Showgirl
Chicago Joe and the Showgirl -> Mariette Hartley -> Bruce Dern
The Cake Eaters -> The Cake Eaters -> Dianne Wiest
Bullets Over Broadway -> Bullets Over Broadway -> Bullets Over Broadway
Cookie -> Cookie -> Cops and Robbersons
Cops and Robbersons -> Cops and Robbersons -> Darling Companion
Darling Companion -> Darling Companion -> Edward Scissorhands
Edward Scissorhands -> Edward Scissorhands -> Five Nights in Maine
Five Nights in Maine -> Footloose -> Footloose
Footloose -> Radio Days -> Radio Days
Radio Days -> The Horse Whisperer -> The Horse Whisperer
Rosario Dawson -> Alexander -> Alexander
Alexander -> Light It Up -> Light It Up
Light It Up -> The First $20 Million Is Always the Hardest -> The First $20 Million Is Always the Hardest
The First $20 Million Is Always the Hardest -> Trance -> Trance
Unforgettable -> Unforgettable -> Shia LaBeouf
Honey Boy -> Honey Boy -> Indiana Jones and the Kingdom of the Crystal Skull
Indiana Jones and the Kingdom of the Crystal Skull -> Indiana Jones and the Kingdom of the Crystal Skull -> Lawless
Lawless -> Lawless -> Man Down
Man Down -> The Battle of Shaker Heights -> The Battle of Shaker Heights
The Greatest Game Ever Played -> The Greatest Game Ever Played -> The Greatest Game Ever Played
Transformers -> Transformers -> Transformers
Wall Street: Money Never Sleeps -> Wall Street: Money Never Sleeps -> Wall Street: Money Never Sleeps
Keanu Reeves -> Bram Stoker's Dracula -> Flying
Flying -> Flying -> Little Buddha
Little Buddha -> Little Buddha -> Replicas
Replicas -> Replicas -> Side by Side Extra: Volume Five
Side by Side Extra: Volume Five -> Side by Side Extra: Volume Five -> Side by Side Extra: Volume Two
Side by Side Extra: Volume Two -> Side by Side Extra: Volume Two -> Speed
Speed -> Speed -> The Matrix
The Matrix -> The Matrix -> The Night Before
The Night Before -> The Night Before -> Rory Cochrane
Scarlett Johansson -> Hitchcock -> Hitchcock
Chris Evans -> The Iceman -> The Iceman
Sebastian Stan -> Mary Stuart Masterson -> Benny & Joon
Benny & Joon -> Cybill Shepherd -> Ryan O'Neal
Paul Rhys -> The Strange Case of Delfina Potocka: The Mystery of Chopin -> The Strange Case of Delfina Potocka: The Mystery of Chopin
The Strange Case of Delfina Potocka: The Mystery of Chopin -> The Strange Case of Delfina Potocka: The Mystery of Chopin -> The Strange Case of Delfina Potocka: The Mystery of Chopin
The Strange Case of Delfina Potocka: The Mystery of Chopin -> Geraldine Chaplin -> Alan Arkin
Going in Style -> Going in Style -> Chen Chang
Li Gong -> Zoe Bell -> Death Proof
Death Proof -> Kristin Kreuk -> Marisa Tomei
My Cousin Vinny -> My Cousin Vinny -> My Cousin Vinny
Untamed Heart -> Bonnie Hunt -> Jumanji
Jumanji -> Jumanji -> Joaquim de Almeida
David Thewlis -> Polly Walker -> Rachel McAdams
Mark Strong -> Jude Law -> Sleuth
Tom Holland -> Michael Keaton -> Jeremy Renner
Embeth Davidtz -> Bicentennial Man -> Feast of July
Junebug -> Junebug -> Murder in the First
Nag van die 19de -> Nag van die 19de -> Nag van die 19de
Simon Magus -> Simon Magus -> Simon Magus
The Emperor's Club -> Daryl Hannah -> 2047: Sights of Death
Centaur -> Memoirs of an Invisible Man -> Ole
Ole -> Ole -> Roxanne
Roxanne -> Roxanne -> Splash
Splash -> Splash -> The Carbon Rush
Your American Teen -> Your American Teen -> Your American Teen
Kenneth Branagh -> How to Kill Your Neighbor's Dog -> How to Kill Your Neighbor's Dog
Mary Shelley's Frankenstein -> Mary Shelley's Frankenstein -> Mary Shelley's Frankenstein
Othello -> Othello -> The Goebbels Experiment
The Theory of Flight -> The Theory of Flight -> Wild Wild West
Wild Wild West -> Vera Farmiga -> Love in the Time of Money
Love in the Time of Money -> Love in the Time of Money -> Robin Wright
The Conspirator -> The Conspirator -> Toys
Toys -> Jeremy Northam -> Mel Gibson
Jeff Kahn -> Jack Black -> Year One
Year One -> Ben Stiller -> Night at the Museum: Secret of the Tomb
Night at the Museum: Secret of the Tomb -> Heather Graham -> From Hell
From Hell -> Angel David -> Natasha Gregson Wagner
Anthony Edwards -> Playing by Heart -> Playing by Heart
Playing by Heart -> Jake Gyllenhaal -> Proof
Proof -> Emily Lloyd -> In Country
In Country -> In Country -> Scorchers
Scorchers -> Scorchers -> The Honeytrap
The Honeytrap -> Under the Hula Moon -> Under the Hula Moon
Under the Hula Moon -> When Saturday Comes -> When Saturday Comes
When Saturday Comes -> Wish You Were Here -> Wish You Were Here
Wish You Were Here -> Woundings -> Woundings
Liz Fraser -> John Lahr -> Elizabeth Ashley
Coma -> Coma -> Leonard Soloway's Broadway
Leonard Soloway's Broadway -> Leonard Soloway's Broadway -> Miriam Shor
John Cusack -> 1408 -> 1408
1408 -> Breakfast with Hunter -> Breakfast with Hunter
One Crazy Summer -> One Crazy Summer -> One Crazy Summer
Pushing Tin -> The Journey of Natty Gann -> The Journey of Natty Gann
The Journey of Natty Gann -> Chazz Palminteri -> Final Recourse
Final Recourse -> Final Recourse -> The Oogieloves in the Big Balloon Adventure
The Oogieloves in the Big Balloon Adventure -> The Oogieloves in the Big Balloon Adventure -> Jennifer Tilly
Pass the Sugar -> Pass the Sugar -> Pass the Sugar
Pass the Sugar -> Pass the Sugar -> Saint Ralph
Saint Ralph -> Peter Falk -> Cops n Roberts
Cops n Roberts -> Cops n Roberts -> Cops n Roberts
Cops n Roberts -> Cops n Roberts -> Faraway, So Close!
Faraway, So Close! -> Faraway, So Close! -> Lakeboat
Lakeboat -> Lakeboat -> The Secret of the Purple Reef
The Secret of the Purple Reef -> The Secret of the Purple Reef -> The Thing About My Folks
The Thing About My Folks -> Michael V. Gazzo -> Alligator
Alligator -> Border Cop -> Border Cop
Border Cop -> Fingers -> Fingers
Fingers -> Nothing to Lose -> Nothing to Lose
Nothing to Lose -> Nothing to Lose -> Nothing to Lose
Robert Davi -> Cyber Vengeance -> Cyber Vengeance
Cyber Vengeance -> The Dukes -> The Dukes
Jack Palance -> Attack -> Attack
Battle of the Commandos -> Hawk the Slayer -> Hawk the Slayer
Hawk the Slayer -> The Lonely Man -> The Lonely Man
The Lonely Man -> The Spy in the Green Hat -> The Spy in the Green Hat
The Spy in the Green Hat -> Chevy Chase -> Wishin' and Hopin'
Wishin' and Hopin' -> Wishin' and Hopin' -> Diane Keaton
Annie Hall -> Annie Hall -> Annie Hall
Baby Boom -> Baby Boom -> Baby Boom
Harry and Walter Go to New York -> Harry and Walter Go to New York -> Manhattan
Manhattan -> Marvin's Room -> The Godfather Part III
The Godfather Part III -> The Only Thrill -> The Only Thrill
Town & Country -> Town & Country -> Town & Country
Kevin Kline -> A Midsummer Night's Dream -> A Midsummer Night's Dream
French Kiss -> French Kiss -> French Kiss
He Makes Me Feel Like Dancin' -> He Makes Me Feel Like Dancin' -> He Makes Me Feel Like Dancin'
Princess Caraboo -> Princess Caraboo -> Princess Caraboo
Silverado -> Silverado -> Soapdish
Soapdish -> Soapdish -> Sophie's Choice
Sophie's Choice -> Sophie's Choice -> Theater of War
Richard Jenkins -> A Goldfish of the Flame -> A Goldfish of the Flame
Bone Tomahawk -> Bone Tomahawk -> Dear John
Dear John -> Dear John -> Eddie
Eddie -> Eddie -> Lullaby
Lullaby -> Lullaby -> The Indian in the Cupboard
The Mudge Boy -> The Mudge Boy -> The Mudge Boy
Untitled Miranda July Project -> Untitled Miranda July Project -> Untitled Miranda July Project
Anthony Michael Hall -> Aftermath -> Aftermath
Exit in Red -> Exit in Red -> Exit in Red
The Photographer -> The Photographer -> Winona Ryder
Black Swan -> Black Swan -> Homefront
Homefront -> Homefront -> Homefront
Homefront -> Little Women -> Lost Souls
Lost Souls -> Lost Souls -> Night on Earth
Night on Earth -> Night on Earth -> The House of the Spirits
The House of the Spirits -> The Private Lives of Pippa Lee -> The Ten
The Ten -> The Ten -> Welcome Home, Roxy Carmichael
Welcome Home, Roxy Carmichael -> Johnny Depp -> Alice Through the Looking Glass
Alice Through the Looking Glass -> Hope and Healing Award Concert -> Hope and Healing Award Concert
Hope and Healing Award Concert -> Hope and Healing Award Concert -> Private Resort
Private Resort -> Rango -> Rango
Rango -> Teyonah Parris -> A Picture of You
A Picture of You -> A Picture of You -> Chi-Raq
Dear White People -> Dear White People -> Dear White People
If Beale Street Could Talk -> Love Under New Management: The Miki Howard Story -> Love Under New Management: The Miki Howard Story
Love Under New Management: The Miki Howard Story -> Where Children Play -> Where Children Play
Where Children Play -> Rosie Perez -> Fearless
Fearless -> Fugly! -> Fugly!
Fugly! -> It Could Happen to You -> It Could Happen to You
King of the Jungle -> King of the Jungle -> The 24 Hour Woman
The 24 Hour Woman -> The 24 Hour Woman -> Kevin Bacon
Elephant White -> Elephant White -> Elephant White
Loverboy -> Loverboy -> New York Skyride
New York Skyride -> New York Skyride -> Songs to Keep: Treasures of an Adirondack Folk Collector
Songs to Keep: Treasures of an Adirondack Folk Collector -> Songs to Keep: Treasures of an Adirondack Folk Collector -> Telling Lies in America
Telling Lies in America -> Telling Lies in America -> Lori Singer
John Lithgow -> Homegrown -> Homegrown
Johnny Skidmarks -> Johnny Skidmarks -> Johnny Skidmarks
Shrek -> Shrek -> The World According to Garp
The World According to Garp -> Mike Starr -> Dumb and Dumber
Making a Killing -> Man with Van -> Man with Van
Mancation -> Mancation -> Tempted
Tempted -> Tempted -> ThE F3aR
ThE F3aR -> ThE F3aR -> Walk a Mile in My Pradas
Walk a Mile in My Pradas -> Walk a Mile in My Pradas -> Mia Farrow
Paul Herman -> Terrified -> Sam Neill
Blackbird -> Blackbird -> Colin McCahon: I Am
Dead Calm -> Dead Calm -> Dead Calm
Possession -> Possession -> Possession
The Adventurer: The Curse of the Midas Box -> The Adventurer: The Curse of the Midas Box -> The Adventurer: The Curse of the Midas Box
Kristin Scott Thomas -> Darkest Hour -> Darkest Hour
Force majeure -> Force majeure -> Force majeure
In the House -> In the House -> In the House
Keeping Mum -> Le bal du gouverneur -> Le bal du gouverneur
Le bal du gouverneur -> Salmon Fishing in the Yemen -> Salmon Fishing in the Yemen
Sarah's Key -> Sarah's Key -> Sarah's Key
The Heir Apparent: Largo Winch -> The Heir Apparent: Largo Winch -> The Heir Apparent: Largo Winch
Up at the Villa -> Up at the Villa -> Anthony Hopkins
Bobby -> Bobby -> Bobby
Hearts in Atlantis -> Hearts in Atlantis -> Solace
Solace -> The Dawning -> The Dawning
The Elephant Man -> The Human Stain -> The Human Stain
The Lion in Winter -> The Lion in Winter -> The Lion in Winter
The Mask of Zorro -> The Mask of Zorro -> The Road to Wellville
Angelina Jolie -> Colin Farrell -> Robert Ri'chard
Forest Whitaker -> Usher Raymond -> Jake Busey
Enrico Colantoni -> Adam Garcia -> Vincent Cassel
Danny Sapani -> Katherine Heigl -> Isabella Kai
Laura San Giacomo -> Natasha Lyonne -> Krippendorf's Tribe
Krippendorf's Tribe -> Krippendorf's Tribe -> Cate Blanchett
Harrison Ford -> The Mosquito Coast -> The Mosquito Coast
Karen Allen -> Jason Clarke -> Tom Hardy
Guy Pearce -> Kate Mara -> Jai Courtney
The Exception -> The Exception -> Anson Mount
Amy Smart -> Stephen Dillane -> Goal II: Living the Dream
Goal II: Living the Dream -> James Paxton -> Elias Koteas
Josh Duhamel -> Tyrese Gibson -> Megan Fox
Michael Douglas -> Falling Down -> Falling Down
Falling Down -> The Prime Ministers: The Pioneers -> Carey Mulligan
Josh Brolin -> Best Laid Plans -> Best Laid Plans
Gary Oldman -> Rosencrantz & Guildenstern Are Dead -> Rosencrantz & Guildenstern Are Dead
Rita Tushingham -> Olivia d'Abo -> Jessica Steen
Bridget Fonda -> Bodies, Rest & Motion -> Ruocheng Ying
Chris Isaak -> Thomas Middleditch -> John Ortiz
Alice Eve -> Martin Scorsese -> Everybody Just Stay Calm
Everybody Just Stay Calm -> Everybody Just Stay Calm -> David Tattersall
Michael Ballhaus -> Wally Pfister -> Richard Linklater
Robert Rodriguez -> Sandra Bullock -> Gun Shy
Gun Shy -> The Prince of Egypt -> The Prince of Egypt
Dennis Hopper -> Chattahoochee -> Joe Morton
Hugo Weaving -> True Love and Chaos -> True Love and Chaos
Laurence Fishburne -> Hoodlum -> Carrie-Anne Moss
Lori Loughlin -> Trinidad Silva -> Theresa Saldana
Helen Mirren -> Calendar Girls -> Calendar Girls
Critical Care -> The Hundred-Foot Journey -> The Hundred-Foot Journey
The Hundred-Foot Journey -> The Madness of King George -> The Nutcracker and the Four Realms
The Quiz Kid -> Danny Huston -> James Franco
Michael Shannon -> Julianne Moore -> Aidan Quinn
Patricia Quinn -> Alice's Restaurant -> Alice's Restaurant
Fall from Innocence -> Fall from Innocence -> Fall from Innocence
Fall from Innocence -> Mary Horror -> Mary Horror
Mary Horror -> Shock Treatment -> Shock Treatment
Shoot Out -> Shoot Out -> Shoot Out
The Outsider -> The Outsider -> The Outsider
Zachariah -> Zachariah -> Zachariah
Penelope Wilton -> Corin Redgrave -> John Shrapnel
Elizabeth McGorian -> Valentina Igoshina -> Michael Caine
Ashanti -> Ashanti -> Ashanti
California Suite -> California Suite -> Mona Lisa
My Generation -> My Generation -> My Generation
My Generation -> My Generation -> My Generation
My Generation -> Secondhand Lions -> The Cider House Rules
The Muppet Christmas Carol -> The Muppet Christmas Carol -> The Muppet Christmas Carol
The Wilby Conspiracy -> The Wilby Conspiracy -> The Wilby Conspiracy
Ann-Margret -> Kurt Russell -> 3000 Miles to Graceland
Dark Blue -> Dark Blue -> Dark Blue
Dreamer: Inspired by a True Story -> Dreamer: Inspired by a True Story -> Dreamer: Inspired by a True Story
Guns of Diablo -> Miracle -> Miracle
Miracle -> Stargate -> Stargate
Swing Shift -> Vanessa Ferlito -> Joe Pesci
Easy Money -> Easy Money -> Easy Money
Gone Fishin' -> Gone Fishin' -> Gone Fishin'
Goodfellas -> Goodfellas -> Jimmy Hollywood
Jimmy Hollywood -> The Death Collector -> The Death Collector
The Death Collector -> The Death Collector -> The Death Collector
The Public Eye -> The Public Eye -> The Super
The Super -> The Super -> Mitchell Whitfield
Ralph Macchio -> Kyle Secor -> Robin Williams
Aladdin -> Aladdin -> Aladdin
Cadillac Man -> Cadillac Man -> Certifiably Jonathan
Certifiably Jonathan -> Certifiably Jonathan -> Club Paradise
Club Paradise -> Dead Poets Society -> Dead Poets Society
Death to Smoochy -> Death to Smoochy -> Death to Smoochy
Good Will Hunting -> Good Will Hunting -> Good Will Hunting
Man of the Year -> Man of the Year -> Man of the Year
One Hour Photo -> One Hour Photo -> Seize the Day
Seize the Day -> Seize the Day -> What Dreams May Come
What Dreams May Come -> Kirsten Dunst -> Small Soldiers
Small Soldiers -> Jonathan Hyde -> Harold Pinter
Oliver Platt -> Ready to Rumble -> Ready to Rumble
Ready to Rumble -> Zig Zag -> James Purefoy
Fisherman's Friends -> Fisherman's Friends -> Fisherman's Friends
Interlude in Prague -> Interlude in Prague -> Jilting Joe
Jilting Joe -> Jilting Joe -> Photo Finish
Photo Finish -> Photo Finish -> Alicia Van Couvering
Alessandro Nivola -> $5 a Day -> $5 a Day
A Most Violent Year -> A Most Violent Year -> A Most Violent Year
Carolina -> Carolina -> Carolina
Coco Before Chanel -> Coco Before Chanel -> Coco Before Chanel
Face/Off -> I Want You -> I Want You
I Want You -> Reach the Rock -> Reach the Rock
The Art of Self-Defense -> The Art of Self-Defense -> The Art of Self-Defense
Christian Slater -> Alone in the Dark -> Alone in the Dark
Alone in the Dark -> Beyond the Stars -> Beyond the Stars
Dawn Rider -> Dawn Rider -> Gleaming the Cube
Gleaming the Cube -> Hard Cash -> Hard Cash
The Deal -> The Deal -> The Deal
The Name of the Rose -> Way of the Wicked -> Way of the Wicked
Way of the Wicked -> Who Is Cletis Tout? -> Who Is Cletis Tout?
Marcel van Heerden -> Pierre Knoesen -> You Must Be Joking Too!
You Must Be Joking Too! -> You Must Be Joking Too! -> Pieter Brand
Stuart Townsend -> About Adam -> About Adam
About Adam -> Chaos Theory -> Queen of the Damned
Queen of the Damned -> Queen of the Damned -> Resurrection Man
Resurrection Man -> Resurrection Man -> Shooting Fish
Shooting Fish -> Shooting Fish -> The Escort
The Escort -> The League of Extraordinary Gentlemen -> The League of Extraordinary Gentlemen
Trojan Eddie -> Trojan Eddie -> Trojan Eddie
Noah Taylor -> Flirting -> Flirting
Life in the Fast Lane -> Life in the Fast Lane -> Life in the Fast Lane
Submarine -> Submarine -> The Double
The Nostradamus Kid -> The Nostradamus Kid -> Sean McGinley
On a Clear Day -> On a Clear Day -> On a Clear Day
Joel Gretsch -> Saving Grace B. Jones -> Saving Grace B. Jones
Saving Grace B. Jones -> Michael Madsen -> Sheryl Crow
Michael McKean -> Massimo Boldi -> Enzo Salvi
Vincenzo Salemme -> Rick Rossovich -> Shelley Duvall
Steve Martin -> Tom Hanks -> Eugene Levy
John Candy -> Karine Vanasse -> Jane Velez-Mitchell
Elizabeth Gould Delmatoff -> Ron Wyden -> Lynn Redgrave
Suzi Hofrichter -> Helena Bonham Carter -> Robert De Niro
Tom Hulce -> Wings of Courage -> Wings of Courage
Irene Jacob -> Nathaniel Parker -> Udo Samel
Gemma Jones -> Holly Aird -> Will Smith
Salma Hayek -> Jill Hennessy -> If I Had Wings
If I Had Wings -> If I Had Wings -> Lost in Time
Lost in Time -> Lost in Time -> Lost in Time
Lost in Time -> Lost in Time -> Lymelife
Molly -> Molly -> Molly
The Acting Class -> The Acting Class -> The Acting Class
Malcolm Gets -> Domenick Lombardozzi -> Tom Wilkinson
James McAvoy -> It Chapter Two -> It Chapter Two
Michael Gambon -> Joan Cusack -> Michael Cera
Sundance Skippy -> Sundance Skippy -> Sundance Skippy
Sundance Skippy -> Olivia Wilde -> Owen Wilson
Dick Van Dyke -> Ian Holm -> Dreamchild
Dreamchild -> Robbie Coltrane -> Sean Connery
Franco Cristaldi e il suo cinema Paradiso -> Franco Cristaldi e il suo cinema Paradiso -> Franco Cristaldi e il suo cinema Paradiso
Never Say Never Again -> Never Say Never Again -> Shalako
Shalako -> Ellen Burstyn -> The Cemetery Club
The Cemetery Club -> Gillian Anderson -> National Theatre Live: All About Eve
National Theatre Live: All About Eve -> National Theatre Live: All About Eve -> National Theatre Live: All About Eve
National Theatre Live: All About Eve -> National Theatre Live: All About Eve -> Hope Davis
Disconnect -> Disconnect -> Disconnect
Duma -> Duma -> Rebel in the Rye
Rebel in the Rye -> Rebel in the Rye -> The Secret Lives of Dentists
Gwyneth Paltrow -> Bruce Willis -> Color of Night
Color of Night -> RED -> Kevin Anderson
Joan Allen -> Faye Dunaway -> James Earl Jones
Denholm Elliott -> Stuart McQuarrie -> Anthony Green
Chris Penn -> Musetta Vander -> Stephen Baldwin
Protection -> Pete Postlethwaite -> Craig Kelly
Sean Bean -> Essex Boys -> Essex Boys
Barbara Durkin -> Clare Clifford -> Trudi Cavanagh
Charlie Creed-Miles -> Sammi Davis -> Rip Torn
Genevieve Bujold -> Campbell Scott -> Crashing
Mrs. Parker and the Vicious Circle -> Stolen -> Stolen
Stolen -> Tovah Feldshuh -> Charlie Hoboken
Charlie Hoboken -> Charlie Hoboken -> Cheaper to Keep Her
Cheaper to Keep Her -> Love Comes Lately -> Love Comes Lately
The Idolmaker -> The Tollbooth -> Triangle: Remembering the Fire
Triangle: Remembering the Fire -> Triangle: Remembering the Fire -> Olympia Dukakis
Moonstruck -> Never Too Late -> Never Too Late
The Golden Greek: The Harry Agganis Story -> The Golden Greek: The Harry Agganis Story -> Tony Shalhoub
Samuel L. Jackson -> Mary McCormack -> Alex Cox
Douglas Brinkley -> Linda Warren -> Demi Moore
G.I. Jane -> Joel Murray -> Billy Bob Thornton
Chrystal -> Chrystal -> Chrystal
Friday Night Lights -> Friday Night Lights -> Friday Night Lights
Mr. Woodcock -> Mr. Woodcock -> Parkland
Parkland -> Parkland -> Sling Blade
Sling Blade -> Sling Blade -> The Alamo
The Alamo -> The Alamo -> The Informers
The Man Who Wasn't There -> The Man Who Wasn't There -> Meredith Salenger
Lainie Kazan -> Ray Wise -> Lucas Elliot Eberl
Teri Polo -> Tia Carrere -> Wayne's World 2
Jaime Pressly -> Cloris Leachman -> Christopher Lloyd
Mike Matusow -> Jose Canseco -> Mike Sexton
Joe Hachem -> James Woods -> Michael Kanev
Adam Butcher -> Arlene Golonka -> Priscilla Barnes
Stephen Furst -> Dody Goodman -> Don Calfa
Herb Edelman -> Horst Buchholz -> Bruno Ganz
Otto Sander -> Denis Leary -> Charles Durning
Robert Forster -> Margia Dean -> Jeff Richards
Richard Chamberlain -> Elizabeth Perkins -> Paul Reiser
Dean Jagger -> Sister Kenny -> Sister Kenny
Sister Kenny -> Robin Riker -> Eddie Albert
Telly Savalas -> The Slender Thread -> Danny De La Paz
Jim Brown -> Directors on Directing 2: The Story of the Storytellers -> Directors on Directing 2: The Story of the Storytellers
Directors on Directing 2: The Story of the Storytellers -> Harvey Keitel -> Tisa Farrow
Paul Gleason -> Youssef Abed-Alnour -> Alexandra Paul
David Campbell -> Juliano Mer-Khamis -> J. Gregory Smith
Matthias Hues -> Josh Mosby -> Peter Bogdanovich
Frank D'Amico -> Robert Strauss -> Lee Marvin
The Raid -> The Raid -> Thomas Hunter
Bernard Bresslaw -> Ray Charleson -> John Terry
Neville Brand -> Anthony Perkins -> Robert Middleton
Janet Leigh -> Night of the Lepus -> Night of the Lepus
Night of the Lepus -> Robert Vaughn -> David McCallum
Annabella Sciorra -> The Night We Never Met -> The Night We Never Met
Conchata Ferrell -> Molly Ringwald -> Woody Allen
Tony Roberts -> Carol Kane -> The Shrink Is In
Sam Shepard -> Harry Dean Stanton: Partly Fiction -> Harry Dean Stanton: Partly Fiction
Kristina Kennedy -> Harold Ramis -> James Caan
Elliott Gould -> Michael Murphy -> Kansas City
Mariel Hemingway -> Leonardo DiCaprio -> Don's Plum
Don's Plum -> Andy Garcia -> Al Pacino
Robert Patrick -> Diane Lane -> Warren Beatty
Nastassja Kinski -> Goldie Hawn -> Rupert Everett
Chronicle of a Death Foretold -> Chronicle of a Death Foretold -> Chronicle of a Death Foretold
Inspector Gadget -> Inspector Gadget -> Michelle Pfeiffer
To Gillian on Her 37th Birthday -> Meg Ryan -> Addicted to Love
Addicted to Love -> My Mom's New Boyfriend -> Jean Reno
Godzilla -> Timothy Hutton -> Judy Collins
Woody Guthrie: Hard Travelin' -> Woody Guthrie: Hard Travelin' -> Woody Guthrie: Hard Travelin'
Woody Guthrie: Hard Travelin' -> Tom McCaffrey -> Jacques d'Amboise
Wendy Hughes -> Phoebe Cates -> Jim Broadbent
Kevin Costner -> 3 Days to Kill -> 3 Days to Kill
3 Days to Kill -> JFK -> JFK
Laffit: All About Winning -> Robin Hood: Prince of Thieves -> Robin Hood: Prince of Thieves
Scott Glenn -> Vertical Limit -> Vertical Limit
Sally Field -> Teri Hatcher -> Cathy Moriarty
Meryl Streep -> Peter MacNicol -> Rita Karin
Tony Kushner -> Derek Deadman -> Tony Devon
Patrick Wilson -> Zipper -> Matthew Fox
Extinction -> Extinction -> Extinction
Henry Thomas -> Briar Patch -> Briar Patch
Briar Patch -> Niagara, Niagara -> Niagara, Niagara
Channing Tatum -> Amanda Seyfried -> Frank Langella
Whoopi Goldberg -> Dennis Farina -> Paparazzi
Paparazzi -> The Grand -> The Grand
Jessica Brown Findlay -> Anne Archer -> Garrett Hedlund
Litefoot -> Pablo Schreiber -> Tom Guiry
Emile Hirsch -> The Motel Life -> The Motel Life
Gina Rodriguez -> Diana Maria Riva -> Evan Rachel Wood
Tony Danza -> Jamie Harrold -> Annabel Schofield
Hank Garrett -> Mickey Rourke -> Reg Rogers
Marisa Berenson -> Natalie Portman -> Mila Kunis
Brenda Jo Reutebuch -> Timothy Paul Taylor -> Jason Statham
Michael Loos -> Kate Bosworth -> Claire Danes
Philip Baker Hall -> Blue Desert -> Sarah Wynter
Ben Chaplin -> Gena Rowlands -> Lisanne Falk
Alan Randolph Scott -> Jeremy Irons -> Antonio Banderas
Shrek Forever After -> Mike Binder -> Jessica Alba
The Veil -> The Veil -> Paul Rudd
Adam Brody -> Jeff Daniels -> Laila Robins
Mia Wasikowska -> Anne Hathaway -> Dave Kushner
Dave Navarro -> Chester Bennington -> Mark McGrath
Rob Morrow -> Atlas Shrugged: Who Is John Galt? -> Going Shopping
Going Shopping -> Into My Heart -> Labor Pains
Labor Pains -> Little Loopers -> Quiz Show
Quiz Show -> Rehearsal -> Rehearsal
Rehearsal -> The Good Doctor -> The Good Doctor
The Good Doctor -> Emily Longstreth -> Abigail Breslin
Zambezia -> Zambezia -> Timothy Olyphant
Isla Fisher -> Andrew Pang -> Lucas Dixon
Jo Mei -> Angela Bassett -> Supernova
Waiting to Exhale -> Waiting to Exhale -> Kyle Gallner
Tyler James Williams -> Tessa Thompson -> Regina King
Gary Dourdan -> Amari Cheatom -> Darius McCrary
Macy Gray -> Brian White -> Leon
Isabella Rossellini -> Jeff Bridges -> Jagged Edge
John Leguizamo -> Empire -> Empire
Radha Mitchell -> Griffin Dunne -> Nicolas Cage
Wendell Pierce -> Julie Carmen -> Cliff Gorman
Patti LuPone -> Karen Duffy -> Marianne Jean-Baptiste
Markus Waldow -> Final Recipe -> Mr. Hurt
Mr. Hurt -> Mr. Hurt -> Mr. Hurt
Ninja: Shadow of a Tear -> Ninja: Shadow of a Tear -> Ninja: Shadow of a Tear
The Rooms -> The Rooms -> The Rooms
The Rooms -> Djimon Hounsou -> Jirantanin Pitakporntrakul
Brawl -> Brawl -> Brawl
Brawl -> Brawl -> Brawl
Brawl -> Dominic Scott Kay -> Kyra Sedgwick
Big Sky -> Big Sky -> Big Sky
Reach Me -> Villains -> James Doohan
Actors in War -> Actors in War -> Actors in War
Star Trek II: The Wrath of Khan -> The Duke -> The Duke
The Duke -> Michael Harkins -> Elya Baskin
Wheelmen -> Wheelmen -> N. Paul Stookey
Pete Seeger -> Dear Governor Cuomo -> Dear Governor Cuomo
Latido Latino II: tiempos mestizos -> Pete & Toshi Get a Camera -> Play On, John: A Life in Music
Play On, John: A Life in Music -> Play On, John: A Life in Music -> Play On, John: A Life in Music
Play On, John: A Life in Music -> Play On, John: A Life in Music -> Rooted in Peace
Swim for the River -> The Power of Their Song: The Untold Story of Latin America's New Song Movement -> The Power of Their Song: The Untold Story of Latin America's New Song Movement
The Power of Their Song: The Untold Story of Latin America's New Song Movement -> The Power of Their Song: The Untold Story of Latin America's New Song Movement -> The Power of Their Song: The Untold Story of Latin America's New Song Movement
Michael Bacon -> Calista Flockhart -> Maximilian Schell
Beyond the Mountains -> Beyond the Mountains -> Five Finger Exercise
Five Finger Exercise -> Labyrinth -> Labyrinth
Labyrinth -> The Deadly Affair -> The Deadly Affair
The Deadly Affair -> You Can't Live Like That -> You Can't Live Like That
Brad Renfro -> The Client -> The Client
Kelly Lynch -> Mr. Magoo -> Mr. Magoo
Mr. Magoo -> Virtuosity -> Virtuosity
Virtuosity -> Hank Azaria -> Frances McDormand
Friends with Money -> Promised Land -> Promised Land
Peter Gallagher -> House on Haunted Hill -> House on Haunted Hill
House on Haunted Hill -> The Man Who Knew Too Little -> The Man Who Knew Too Little
The Man Who Knew Too Little -> The War Boys -> The War Boys
The War Boys -> Watch It -> Watch It
Watch It -> John Kapelos -> Cold Blooded
Cold Blooded -> Cold Blooded -> Everybody Wants to Be Italian
Everybody Wants to Be Italian -> Everybody Wants to Be Italian -> The Boost
Cameron Diaz -> Sex Tape -> Sex Tape
Mike Myers -> Shrek 2 -> Mary Beth Hurt
Chilly Scenes of Winter -> Chilly Scenes of Winter -> Chilly Scenes of Winter
Interiors -> Parents -> Parents
Slaves of New York -> Slaves of New York -> Slaves of New York
Glenn Close -> The Stepford Wives -> What I Want My Words to Do to You: Voices from Inside a Women's Maximum Security Prison
What I Want My Words to Do to You: Voices from Inside a Women's Maximum Security Prison -> What I Want My Words to Do to You: Voices from Inside a Women's Maximum Security Prison -> Lauren Holly
Entropy -> Entropy -> Jude Moran
Laura Fraser -> Ursula Parker -> Matt Kawczynski
Danica McKellar -> Burt Reynolds -> Saffron Burrows
Randy Austin -> Peter Evangelista -> Saul Stein
Joe Blute -> Tom Arnold -> Tom Archdeacon
Nathaniel Marston -> Lisa Zane -> Bex Taylor-Klaus
Kate Winslet -> Paul Casserly -> Nicole Kidman
Rod Mullinar -> Billy Zane -> Margit Carstensen
Isabelle Adjani -> Heinz Bennent -> Aneurin Barnard
Lena Headey -> Michael Sheen -> Ben Mendelsohn
Lily James -> Broken -> Broken
Broken -> Broken -> Broken
Pride and Prejudice and Zombies -> Pride and Prejudice and Zombies -> Pride and Prejudice and Zombies
Yesterday -> Yesterday -> Yesterday
Francois Cluzet -> Patrick Bruel -> Alan Bates
Fabrice Luchini -> Vincent Schmitt -> Ernst Umhauer
Maggie Smith -> Laurent Grevill -> Didier Flamand
Jacques Sereys -> Amr Waked -> Ewan McGregor
Frederic Pierrot -> Melusine Mayance -> Niels Arestrup
Predrag 'Miki' Manojlovic -> Melanie Thierry -> Tomer Sisley
James Fox -> Thoroughly Modern Millie -> Sean Penn
Harry Belafonte -> Hava Nagila: The Movie -> Hava Nagila: The Movie
Nathalie Madore -> Felixe Ross -> Anton Yelchin
Mika Boorem -> Abbie Cornish -> Jeffrey Dean Morgan
Trevor Howard -> Jean Simmons -> Anne Bancroft
The Kid from Left Field -> The Kid from Left Field -> The Kid from Left Field
The Kid from Left Field -> The Restless Breed -> The Restless Breed
The Restless Breed -> The Restless Breed -> The Sunchaser
The Sunchaser -> To Be or Not to Be -> Gary Sinise
Ed Harris -> Peter O'Toole -> Katharine Hepburn
John Castle -> Catherine Zeta-Jones -> Jose Maria de Tavira
Matthew Broderick -> Biloxi Blues -> Biloxi Blues
Diminished Capacity -> Diminished Capacity -> Lazy Susan
Lazy Susan -> Lazy Susan -> Max Dugan Returns
Max Dugan Returns -> Richard Dreyfuss -> Always
Always -> Always -> American Graffiti
American Graffiti -> American Graffiti -> Killing Winston Jones
Killing Winston Jones -> Nuts -> Nuts
Nuts -> Piranha 3D -> Signs of the Time
Signs of the Time -> Signs of the Time -> Whose Life Is It Anyway?
Whose Life Is It Anyway? -> Gregory Smith -> Jenna Elfman
Jadrien Steele -> River Phoenix -> Christopher Plummer
Lois Alessandra -> Kuno Becker -> Spoken Word
Spoken Word -> Anna Friel -> Robert Duvall
Hotel Colonial -> Hotel Colonial -> Hotel Colonial
John Q -> John Q -> The Apostle
The Apostle -> The Apostle -> The Outfit
Tomorrow -> Tomorrow -> Tomorrow
Barbara Hershey -> Rachel Ticotin -> Leonard Nimoy
Carpati: 50 Miles, 50 Years -> Deathwatch -> Deathwatch
Deathwatch -> Minyan in Kaifeng -> My Brother Vincent
The Story of Computer Graphics -> Titanica -> Titanica
Titanica -> Gene Wolande -> Reese Witherspoon
Cruel Intentions -> Cruel Intentions -> Tim Roth
Backsliding -> Backsliding -> Backsliding
Chronic -> Chronic -> Chronic
The Incredible Hulk -> The Incredible Hulk -> Livio Badurina
Eric Stoltz -> Hank Blumenthal -> Whit Stillman
Mira Sorvino -> Jose Zuniga -> Liam Neeson
Val Kilmer -> Ralph Fiennes -> Pamela Reed
Miranda Otto -> Naveen Andrews -> Vanessa Williams
Julie Walters -> John Alderton -> James Spader
Jack's Back -> Jack's Back -> Jack's Back
Mannequin -> Mannequin -> Mannequin
Sex, Lies, and Videotape -> True Colors -> True Colors
Om Puri -> Manish Dayal -> Charlotte Le Bon
Rupert Graves -> Keira Knightley -> Peter Jeffrey
Arlo Guthrie -> James Broderick -> The Tree
The Tree -> The Tree -> Thom Haverstock
Isabelle Mejias -> Tom McDonald -> Pandora Richardson
Shawn C. Phillips -> M. Kelley -> Susie Duecker
Richard O'Brien -> Jessica Harper -> Gregory Peck
Susan Tyrrell -> Robert F. Lyons -> Sterling Hayden
Craig Wasson -> Niall O'Brien -> Country Joe and the Fish
Don Johnson -> Bucky Larson: Born to Be a Star -> Bucky Larson: Born to Be a Star
John Rubinstein -> Peter Ustinov -> Kabir Bedi
Beverly Johnson -> Jane Fonda -> Alan Alda
Cathy Tyson -> Alexandra Kosasie -> Mary Quant
David Bailey -> Arya Vasco -> Bryan Warow
Lutesha -> Twiggy -> Haley Joel Osment
Almost Friends -> Almost Friends -> Almost Friends
Bogus -> Edges of the Lord -> Edges of the Lord
Edges of the Lord -> The Jungle Book 2 -> The Jungle Book 2
Tobey Maguire -> Dave Goelz -> Jerry Nelson
Steve Whitmire -> Nicol Williamson -> Prunella Gee
Sidney Poitier -> Courteney Cox -> Cocoon: The Return
November -> November -> November
Scream 2 -> Scream 2 -> The Runner
The Runner -> Ving Rhames -> Scott Speedman
Michael Michele -> Kris Kristofferson -> Dakota Fanning
Oded Fehr -> Jan Merlin -> Nathan West
Noah Emmerich -> Patricia Clarkson -> Jaye Davidson
Viveca Lindfors -> Christine Lahti -> Rodney Dangerfield
Geraldine Fitzgerald -> Candice Azzara -> Danny Glover
Rosanna Arquette -> Lynn Whitfield -> Ray Liotta
Lorraine Bracco -> Jason Beghe -> An Experiment in Fear: The Making of Monkey Shines
An Experiment in Fear: The Making of Monkey Shines -> An Experiment in Fear: The Making of Monkey Shines -> Atlas Shrugged II: The Strike
Atlas Shrugged II: The Strike -> Atlas Shrugged II: The Strike -> Going Clear: Scientology & the Prison of Belief
Monkey Shines -> Monkey Shines -> Monkey Shines
Survivors of Malmedy: December 1944 -> Victoria Abril -> After Darkness
After Darkness -> After Darkness -> Comin' at Ya!
Don't Tempt Me -> Don't Tempt Me -> Don't Tempt Me
L'addition -> L'addition -> L'addition
Frank Vincent -> Joe Cortese -> Lou Criscuolo
Keith Davis -> Bobby Alto -> Bryan Travis Smith
Richard Riehle -> Ruben Blades -> Disorganized Crime
Disorganized Crime -> From Son to Salsa -> From Son to Salsa
From Son to Salsa -> Imagining Argentina -> Invasion
Invasion -> Invasion -> Sono, Sono, Tite Curet!!!
Sono, Sono, Tite Curet!!! -> Sono, Sono, Tite Curet!!! -> Yo soy la Salsa
Yo soy la Salsa -> Yo soy la Salsa -> Madolyn Smith Osborne
Vincent Gardenia -> Linda Larkin -> Jonathan Freeman
Scott Weinger -> Tim Robbins -> Fran Drescher
Jonathan Winters -> Nora Dunn -> Howie Mandel
Jimmy Cliff -> Rick Moranis -> Josh Charles
Ethan Hawke -> Edward Norton -> Catherine Keener
Danny DeVito -> Matt Damon -> Ben Affleck
Stellan Skarsgard -> Christopher Walken -> Dark Horse
Wild Side -> Wild Side -> Laura Linney
Lewis Black -> Michael Vartan -> Demoted
Demoted -> Dylan Smith -> David Bickford
Glenne Headly -> Richard B. Shull -> Max von Sydow
Cuba Gooding Jr. -> David Cross -> Alvin and the Chipmunks
Alvin and the Chipmunks -> Alvin and the Chipmunks -> Alvin and the Chipmunks: The Squeakquel
Alvin and the Chipmunks: The Squeakquel -> Run Ronnie Run -> Run Ronnie Run
Run Ronnie Run -> The Legend of Secret Pass -> The Legend of Secret Pass
The Legend of Secret Pass -> Jay Mohr -> David Arquette
Bill Goldberg -> Scott Caan -> Wesley Snipes
Tuppence Middleton -> Daniel Mays -> Noel Clarke
Morfydd Clark -> Samantha Barks -> Benjamin Whitrow
Geraldine Somerville -> Patricia Hodge -> Aidan Gillen
Colette Brown -> Georgina Hale -> Sharon Stone
Dean Cain -> Jessica Chastain -> David Oyelowo
Oscar Isaac -> Randy Quaid -> Shirley MacLaine
Julia Stiles -> A Guy Thing -> Benoit Poelvoorde
Audrey Tautou -> Marie Gillain -> John Travolta
The Punisher -> Labina Mitevska -> Luka Petrusic
Rachel Weisz -> Karen Sillas -> Bruce Norris
Jesse Eisenberg -> Steve Terada -> Imogen Poots
Stephen Dorff -> Backbeat -> Botched
Botched -> Botched -> Brake
Brake -> Brake -> Carjacked
Tara Reid -> Frank C. Turner -> A War Story
A War Story -> Family Reunion -> Family Reunion
Family Reunion -> Martin Sheen -> Robert Foxworth
Donald Sutherland -> Joanna -> Joanna
Joanna -> The Trouble with Spies -> The Trouble with Spies
The Trouble with Spies -> Virus -> Virus
Virus -> Younger and Younger -> Younger and Younger
Younger and Younger -> Ben Cotton -> In No Particular Order
In No Particular Order -> In No Particular Order -> In No Particular Order
In No Particular Order -> In No Particular Order -> The Cabin Movie
The Cabin Movie -> The Cabin Movie -> Steven Bauer
Heartlines -> Heartlines -> The Versace Murder
The Versace Murder -> The Versace Murder -> Woman of Desire
Woman of Desire -> Woman of Desire -> Richard Herd
Corporate Affairs -> Corporate Affairs -> Sara Downing
Burning Annie -> Burning Annie -> Burning Annie
Rats -> Rats -> The Grift
The Grift -> Vincent Laresca -> Robert Loggia
Flypaper -> Snapshot -> Snapshot
Snapshot -> Selma Blair -> A Dirty Shame
Kill Me Later -> Kill Me Later -> Kill Me Later
Strong Island Boys -> Strong Island Boys -> The Broccoli Theory
The Broccoli Theory -> The Broccoli Theory -> Colm Feore
A Perfect Son -> Intervention -> Intervention
Intervention -> Six Reasons Why -> Six Reasons Why
Six Reasons Why -> The Herd -> The Herd
The Herd -> The Prodigy -> The Prodigy
The Prodigy -> Helmut Qualtinger -> Abelard
Abelard -> Abelard -> Das Diarium des Dr. Doblinger
Das Diarium des Dr. Doblinger -> Das Diarium des Dr. Doblinger -> Der Paukenspieler
Der Paukenspieler -> Der Paukenspieler -> Grandison
Krankensaal 6 -> Krankensaal 6 -> Krankensaal 6
Mann im Schatten -> Mann im Schatten -> Mann im Schatten
Tales from the Vienna Woods -> Emily Tennant -> Poe: Last Days of the Raven
Poe: Last Days of the Raven -> Poe: Last Days of the Raven -> Vinnie Jones
Throwdown -> Jake Croker -> The Lonely Light of Home
The Lonely Light of Home -> The Lonely Light of Home -> Portia de Rossi
Tim Allen -> Eddie Eckstein -> Cobus Rossouw
Leon Schuster -> Frances O'Connor -> Tommy Tiernan
Kate Hudson -> Ryan Reynolds -> Aaliyah
Marguerite Moreau -> Vincent Perez -> Brenda Fricker
George Shane -> David Williamson -> Rowena Cooper
Dan Futterman -> Kate Beckinsale -> Liza Walker
Daniel Auteuil -> Jason Flemyng -> Peta Wilson
Richard Harris -> Aislin McGuckin -> Stephen Rea
Thandie Newton -> Bartholomew Rose -> Fairuza Balk
Patrick Dempsey -> Tea Leoni -> Craig Roberts
Sally Hawkins -> Wallace Shawn -> Peter Gwynne
Arthur Dignam -> Brenda Blethyn -> Peter Mullan
Billy Boyd -> Penelope Ann Miller -> Michael Biehn
Tatum O'Neal -> Elizabeth McGovern -> Craig Sheffer
Richard Harmon -> I Still See You -> I Still See You
Craig Bierko -> Jaren Brandt Bartlett -> Carmen Tonry
Han Soto -> Zhener Wang -> Ziming Du
Griff Furst -> Yu Wang -> Alec Baldwin
Thomas Jane -> 1922 -> 1922
1922 -> Dark Country -> Padamati Sandhya Ragam
Padamati Sandhya Ragam -> Stander -> Stander
Aaron Eckhart -> My All-American -> My All-American
Elisabeth Shue -> Ken Murton -> Elizabeth Holder
Jody Booth -> Bill Skarsgard -> It
Moomins and the Winter Wonderland -> Simon & the Oaks -> Simon & the Oaks
The Crown Jewels -> The Crown Jewels -> Sophia Lillis
Brittany Flickinger -> Zooey Deschanel -> Minnie Driver
Rob Corddry -> Caris Corfman -> Coral Browne
Marco Bellocchio -> Suso Cecchi D'Amico -> Giuliano Gemma
Kim Basinger -> Klaus Maria Brandauer -> Stephen Boyd
The Third Secret -> Brigitte Bardot -> Danny Aiello
Diane Ladd -> Monica Dolan -> Rhashan Stone
Julian Ovenden -> Sheila Reid -> Ian Drysdale
Stanley Townsend -> Haley Ramm -> Jonah Bobo
Jason Bateman -> Mary Makhatho -> Meet the Radebes
Meet the Radebes -> Alex Michaeletos -> Kevin Spacey
Victor Garber -> Nicholas Hoult -> Robin Tunney
August -> August -> August
End of Days -> End of Days -> End of Days
Julian Po -> The Zodiac -> The Zodiac
The Zodiac -> Lesley Ann Warren -> Jane March
Mary-Louise Parker -> Golden Exits -> Golden Exits
Aron Tager -> Alex Kingston -> Bukowski
Bukowski -> Bukowski -> Warrior Queen
Warrior Queen -> Gareth Milne -> Caleigh White
Believers Among Us -> Believers Among Us -> Jennifer Jason Leigh
Amityville: The Awakening -> Amityville: The Awakening -> Palindromes
Harold Smith -> Blythe Danner -> The Love Letter
Anthony Bailey -> Robin Hood Junior -> Robin Hood Junior
Robin Hood Junior -> Sex and the Other Woman -> Sex and the Other Woman
Sex and the Other Woman -> Sex and the Other Woman -> Sex and the Other Woman
Anita Gillette -> Ken Garito -> Austin Pendleton
Steven M. Gagnon -> Mac Davis -> Otto Tausig
Rhea Perlman -> Paul Land -> Idina Menzel
Suzanne Pred Bass -> Dennis Clancey -> Leigh Benin
Cher -> Jean Lapointe -> Jan Rubes
Johnny Pesky -> Curt Gowdy -> Viggo Mortensen
Kamron Ross Stacey -> Lisa Blount -> David Rhodes
Lucas Black -> Derek Luke -> Jay Hernandez
Seann William Scott -> Amy Poehler -> Zac Efron
Paul Giamatti -> Tom Welling -> J.T. Walsh
Dwight Yoakam -> John Ritter -> Emilio Echevarria
Jason Patric -> Dennis Quaid -> Jon Foster
Michael Badalucco -> James Gandolfini -> Dana Carvey
Rosalind Russell -> Fast and Loose -> Fast and Loose
Fast and Loose -> Fast and Loose -> Live, Love and Learn
Live, Love and Learn -> Man-Proof -> Man-Proof
Man-Proof -> Rosie! -> Roughly Speaking
The Casino Murder Case -> The Casino Murder Case -> The Casino Murder Case
The Guilt of Janet Ames -> The Guilt of Janet Ames -> The Guilt of Janet Ames
Under Two Flags -> Under Two Flags -> Under Two Flags
What a Woman! -> What a Woman! -> Alexander Knox
Philip Merivale -> Steven Hill -> James Avery
After Romeo -> After Romeo -> After Romeo
Antonia Pantoja Presente! -> Chasing Sunsets -> Chasing Sunsets
Chasing Sunsets -> Dancing in September -> Honeybee
Honeybee -> Honeybee -> Restraining Order
The Grind -> The Grind -> The Grind
Charles Burnett -> Ben Caldwell -> Van Heflin
Richard Boone -> DeForest Kelley -> Beyond Our Own
Beyond Our Own -> Beyond Our Own -> Fear in the Night
Fear in the Night -> Fear in the Night -> Gunfight at Comanche Creek
Gunfight at Comanche Creek -> Gunfight at Comanche Creek -> Variety Girl
Variety Girl -> Variety Girl -> Stuart Whitman
Rory Calhoun -> Tim Guinee -> Jeanne Tripplehorn
David James Elliott -> David Lynch -> Celluloid Dreams
Celluloid Dreams -> Celluloid Dreams -> Great Directors
Great Directors -> Great Directors -> My Beautiful Broken Brain
My Beautiful Broken Brain -> My Beautiful Broken Brain -> Harry Dean Stanton
Miranda Richardson -> Kevin Connolly -> Devious Beings
Devious Beings -> Devious Beings -> Entourage
Entourage -> Entourage -> Tyrone
Tyrone -> Tyrone -> Scott Bloom
Irene Papas -> Island -> Island
Island -> Witness Out of Hell -> Witness Out of Hell
Witness Out of Hell -> Z -> Z
Z -> Gian Maria Volonte -> Ornella Muti
Michelle Trachtenberg -> Joely Fisher -> Laurie Fortier
Tcheky Karyo -> Kelly Preston -> Colin Hanks
Maria Pitillo -> Ronnie Gilbert -> Forever Activists: Stories from the Veterans of the Abraham Lincoln Brigade
Forever Activists: Stories from the Veterans of the Abraham Lincoln Brigade -> Forever Activists: Stories from the Veterans of the Abraham Lincoln Brigade -> Isn't This a Time! A Tribute Concert for Harold Leventhal
Isn't This a Time! A Tribute Concert for Harold Leventhal -> The Women of Summer -> Joan Baez
Jack Elliott -> Hoyt Axton -> Hailee Steinfeld
Connie Nielsen -> Amber Heard -> Walter Matthau
Jack Lemmon -> Laffit Pincay Jr. -> Morgan Freeman
Mary Elizabeth Mastrantonio -> Chris O'Donnell -> Bill Paxton
Ray Winstone -> Jeffrey Donovan -> Book of Shadows: Blair Witch 2
Book of Shadows: Blair Witch 2 -> Book of Shadows: Blair Witch 2 -> Sam & Joe
Sam & Joe -> Sam & Joe -> Throwing Down
Throwing Down -> Throwing Down -> Quinn McColgan
Clara Lago -> Dominique Swain -> As Virgins Fall
As Virgins Fall -> As Virgins Fall -> Happy Campers
Happy Campers -> New Best Friend -> New Best Friend
Stuntmen -> Tart -> Tart
The Dark Field -> The Dark Field -> The Dark Field
The Fast and the Fierce -> Arie Verveen -> James Urbaniak
Stephen Lang -> Michael Parks -> Cole Hauser
Daniel Baldwin -> Woody Harrelson -> Cheryl Hines
Nancy Youngblut -> Doc Divecchio -> D.B. Sweeney
Eddie Murphy -> Lily Rabe -> Aleksa Palladino
Laura Regan -> Victoria Foyt -> Lee Grant
Claire Forlani -> Mary Tyler Moore -> Lela Rochon
Jay R. Ferguson -> Paul Scofield -> John Turturro
Deborah Kara Unger -> Bruce Greenwood -> Breanne Hill
Orlando Bloom -> Taraji P. Henson -> Riley Keough
Jeff Goldblum -> Jeremy Suarez -> Peter Facinelli
Whitney Houston -> Loretta Devine -> Peter Coyote
The Reality of Truth -> Denise Richards -> Peter Sarsgaard
Chin Han -> A Different Sun -> A Different Sun
A Different Sun -> Blindness -> Blindness
Blindness -> Skyscraper -> Skyscraper
Pongsatorn Jongwilak -> ATM: Er Rak Error -> ATM: Er Rak Error
ATM: Er Rak Error -> My Space -> My Space
My Space -> Pee Mak -> Pee Mak
Pee Mak -> Mashannoad Suvalmas -> Marie Broenner
Sunny Suwanmethanont -> A Gift -> A Gift
Dear Dakanda -> Dear Dakanda -> Dear Dakanda
Die Tomorrow -> Die Tomorrow -> Die Tomorrow
I Fine..Thank You Love You -> I Fine..Thank You Love You -> I Fine..Thank You Love You
I Fine..Thank You Love You -> Shambala -> Shambala
Scott Adkins -> Abduction -> Abduction
Abduction -> El Gringo -> El Gringo
El Gringo -> Universal Soldier: Day of Reckoning -> Universal Soldier: Day of Reckoning
Universal Soldier: Day of Reckoning -> Mika Hijii -> ...And Love
...And Love -> ...And Love -> ...And Love
Akko's Secret -> Ninja -> Ninja
Kane Kosugi -> Journey of Honor -> Journey of Honor
Journey of Honor -> Yoko Takano -> Savika Chaiyadej
100 Percent Love Aata -> 100 Percent Love Aata -> Chum thaang rot fai phii
Chum thaang rot fai phii -> Chum thaang rot fai phii -> Chum thaang rot fai phii
Chum thaang rot fai phii -> Jan Dara: The Beginning -> Jan Dara: The Finale
Jan Dara: The Finale -> Jan Dara: The Finale -> Jan Dara: The Finale
Jan Dara: The Finale -> Jan Dara: The Finale -> Love Slave
Love Slave -> Markandeyan -> Markandeyan
Markandeyan -> The Holy Man -> The Holy Man
The Holy Man -> Kavee Tanjararak -> Omen
Omen -> Omen -> Omen
Ponglang Amazing Theater -> Ponglang Amazing Theater -> Ponglang Amazing Theater
Ponglang Amazing Theater -> Ponglang Amazing Theater -> Ponglang Amazing Theater
Sexphone & the Lonely Wave -> Sexphone & the Lonely Wave -> Sexphone & the Lonely Wave
Sexphone & the Lonely Wave -> Ase Wang -> Clouds in My Coffee
Clouds in My Coffee -> Clouds in My Coffee -> Clouds in My Coffee
Jakkrit Kanokpodjananon -> Suchao Pongwilai -> Ameen
Ameen -> Ameen -> Ameen
Ameen -> Citizen II -> Citizen II
Distortion -> Distortion -> Distortion
Distortion -> Distortion -> Kor Kwam Rak Bang Dai Mai
Kor Kwam Rak Bang Dai Mai -> Kor Kwam Rak Bang Dai Mai -> Mae Luek Kerd Dai
Ong-Bak: The Thai Warrior -> Ong-Bak: The Thai Warrior -> Yom-Pee-Poa
Yom-Pee-Poa -> Yuhkoh Matsuguchi -> Anthony Ryu
Khun Phan -> Sunset at Chaophraya -> Sunset at Chaophraya
Sunset at Chaophraya -> Sunset at Chaophraya -> Sunset at Chaophraya
Sunset at Chaophraya -> Jay Morin -> Jawed El Berni
David Ismalone -> Mystic Blade -> Mystic Blade
Frank Grillo -> Once Upon a Time in Staten Island -> Once Upon a Time in Staten Island
Once Upon a Time in Staten Island -> Wheelman -> Wheelman
Wheelman -> Bella Thorne -> Frog Kingdom
Frog Kingdom -> Frog Kingdom -> Keep Watching
Keep Watching -> Keep Watching -> Midnight Sun
Midnight Sun -> Midnight Sun -> Ride
Ride -> Ride -> Ride
Ride -> Ride -> Shovel Buddies
Shovel Buddies -> The Duff -> You Get Me
You Get Me -> You Get Me -> Aaron Tveit
Created Equal -> Created Equal -> Created Equal
Lauren Cohan -> Maika Monroe -> Bokeh
Bokeh -> Bokeh -> Echoes of War
Echoes of War -> Echoes of War -> Joseph Wapner
Richard Anderson -> Anatomy of a Film -> Anatomy of a Film
Anatomy of a Film -> Classic Hollywood Cinemas -> Classic Hollywood Cinemas
Classic Hollywood Cinemas -> Deadfall Trail -> Deadfall Trail
Deadfall Trail -> Fable -> Fable
Fable -> Nowhere to Hide -> Nowhere to Hide
Nowhere to Hide -> Secret of Bigfoot -> Secret of Bigfoot
The Deadbeats -> The Deadbeats -> The Deadbeats
The Deadbeats -> The Glass Shield -> The Glass Shield
The Glass Shield -> When the World Breaks -> When the World Breaks
When the World Breaks -> Richard Kline -> Knight to F4
Knight to F4 -> Knight to F4 -> William Shatner
A Christmas Horror Story -> A Christmas Horror Story -> A Christmas Horror Story
Free Enterprise -> Free Enterprise -> Free Enterprise
Incubus -> Incubus -> Kingdom of the Spiders
Kingdom of the Spiders -> Kingdom of the Spiders -> Mysteries of the Gods
Mysteries of the Gods -> Mysteries of the Gods -> Shoot or Be Shot
Shoot or Be Shot -> Shoot or Be Shot -> Stalking Santa
Stalking Santa -> Stalking Santa -> Star Trek: Generations
The Intruder -> The Intruder -> The Intruder
The Third Walker -> To Your Last Death -> To Your Last Death
Courtnee Draper -> The Immaculate Misconception -> The Immaculate Misconception
The Prodigy -> The Prodigy -> The Prodigy
The Prodigy -> The Prodigy -> The Prodigy
John Neville -> A Study in Terror -> A Study in Terror
A Study in Terror -> Dinner at Fred's -> Dinner at Fred's
Dinner at Fred's -> Moving Malcolm -> Moving Malcolm
Moving Malcolm -> Oscar Wilde -> Oscar Wilde
Oscar Wilde -> Unearthly Stranger -> Unearthly Stranger
Unearthly Stranger -> Water Damage -> Jeremy Maxwell
Jim Beaver -> Ah! Silenciosa -> Ah! Silenciosa
Ah! Silenciosa -> Billy Boy -> Billy Boy
Billy Boy -> Cooties -> Dark and Stormy Night
Dark and Stormy Night -> Dark and Stormy Night -> Remember the Sultana
Remember the Sultana -> The Frontier -> Twogether
Twogether -> Twogether -> Lisa Arturo
Border to Border -> Border to Border -> Border to Border
One More Round -> One More Round -> One More Round
Stripped Down -> Stripped Down -> Stripped Down
Natalie Merchant -> Paradise Is There -> Paradise Is There
Joan Osborne -> David Byrne -> By the Ways: A Journey with William Eggleston
By the Ways: A Journey with William Eggleston -> By the Ways: A Journey with William Eggleston -> Stop Making Sense
Stop Making Sense -> Stop Making Sense -> Mika Seeger
John Cohen -> Rayna Gellert -> Ray Alden
Bruce Molsky -> Dick Connette -> Sonya Cohen
Deepak Chopra -> Change Is Gonna Come -> Change Is Gonna Come
Change Is Gonna Come -> Change Is Gonna Come -> Urban Sutra
Christopher Swain -> Roy Brown -> Danny and the Lions
Danny and the Lions -> Danny and the Lions -> Reality Check: The Musical
Robert De Cormier -> Jackson Browne -> American Music: Off the Record
American Music: Off the Record -> Song of the Kauri -> Song of the Kauri
Song of the Kauri -> Song of the Kauri -> The Secret Policeman's Third Ball
The Secret Policeman's Third Ball -> The Secret Policeman's Third Ball -> Lichi Fuentes
Tao Rodriguez-Seeger -> Raf Vallone -> Bitter Rice
Bitter Rice -> Bitter Rice -> Harlow
Harlow -> Harlow -> Harlow
Harlow -> Harlow -> Harlow
The Adultress -> The Adultress -> Theodore Bikel
A Sacred Duty -> Chance Meeting -> Chance Meeting
Chance Meeting -> Darker Than Amber -> Darker Than Amber
Darker Than Amber -> Escape from the Iron Curtain -> Escape from the Iron Curtain
Escape from the Iron Curtain -> Escape from the Iron Curtain -> Escape from the Iron Curtain
Humphrey Bogart: Behind the Legend -> Humphrey Bogart: Behind the Legend -> Journey 4 Artists
Journey 4 Artists -> Journey 4 Artists -> The Blue Angel
The Blue Angel -> The Enemy Below -> The Pride and the Passion
The Pride and the Passion -> The Pride and the Passion -> Jack Hawkins
Gideon of Scotland Yard -> Gideon of Scotland Yard -> Land of Fury
Land of Fury -> Land of Fury -> Malta Story
Malta Story -> Malta Story -> Twice Upon a Time
Richard Beymer -> Hemingway's Adventures of a Young Man -> Hemingway's Adventures of a Young Man
Hemingway's Adventures of a Young Man -> Home the Horror Story -> Home the Horror Story
Home the Horror Story -> Playing Patti -> Playing Patti
Playing Patti -> Playing Patti -> Playing Patti
Scream Free! -> Scream Free! -> Scream Free!
The Diary of Anne Frank -> The Diary of Anne Frank -> The Diary of Anne Frank
Christopher Chaplin -> Il cinema ritrovato: istruzioni per l'uso -> Il cinema ritrovato: istruzioni per l'uso
Il cinema ritrovato: istruzioni per l'uso -> Il cinema ritrovato: istruzioni per l'uso -> Il cinema ritrovato: istruzioni per l'uso
Milos Kopecky -> Adele's Dinner -> Adele's Dinner
Adele's Dinner -> How to Drown Dr. Mracek, the Lawyer -> How to Drown Dr. Mracek, the Lawyer
How to Drown Dr. Mracek, the Lawyer -> Lemonade Joe -> Lemonade Joe
Lemonade Joe -> Slasti Otce vlasti -> Slasti Otce vlasti
Christian Thuri -> Simone Signoret -> Adua e le compagne
Adua e le compagne -> La solitude du chanteur de fond -> La solitude du chanteur de fond
Le joli mai -> Les mauvais coups -> Les mauvais coups
Les mauvais coups -> Harriet Andersson -> A Lesson in Love
A Lesson in Love -> A Lesson in Love -> Barbara - Wild wie das Meer
Barbara - Wild wie das Meer -> Barbara - Wild wie das Meer -> Dream of Happiness
Dream of Happiness -> Dream of Happiness -> Happy End
Happy End -> Happy End -> Happy End
Happy End -> Happy End -> Happy End
Happy End -> Happy End -> Har borjar aventyret
Har borjar aventyret -> Har borjar aventyret -> Hoppsan!
Hoppsan! -> Kampf um Rom II - Der Verrat -> Kampf um Rom II - Der Verrat
Kampf um Rom II - Der Verrat -> Siska -> To Love
To Love -> To Love -> James Mason
Aleksandr Nevzorov -> Olya Dvoretskaya -> Susan Sarandon
Tommy Lee Jones -> Matt Keeslar -> Leslie Nielsen
Nick Chinlund -> Stephen Spinella -> Russell Crowe
Denzel Washington -> Jennifer Aniston -> John Krasinski
Hal Holbrook -> Famke Janssen -> Taye Diggs
Geoffrey Rush -> Richard Wilson -> Joanne Whalley
Bill Murray -> Benjamin Walker -> Brian J. Smith
Victor Rasuk -> Jon Tenney -> John C. McGinley
Suzy Amis -> Brian Markinson -> Kenneth Welsh
Tony Nardi -> Jay Jablonski -> Cerina Vincent
John Enos III -> Sean Young -> Ellie Kemper
Jason Segel -> Julie Andrews -> Peter Riegert
John Heard -> Kenneth McMillan -> Kristin Griffith
Bryan Madorsky -> Sandy Dennis -> Chris Sarandon
Adam Coleman Howard -> Bernadette Peters -> Bette Midler
Eve Ensler -> Mary Alice -> Hazelle Goodman
Judith Godreche -> Kelly Macdonald -> Nicholas B. York
Charlie Booty -> S.R. Stevens -> Gian Carlo Bono
Karl van Allen -> Bella Heathcote -> Sam Riley
Jack Huston -> James Corden -> Ana de Armas
Kate McKinnon -> Carol Channing -> Glen Campbell
Regina Spektor -> Lloyd Bridges -> Ray Collins
Dan Dailey -> Billy Chapin -> Jay C. Flippen
Leo Gordon -> Scott Marlowe -> Billy Miller
Alexandra Tydings -> Jon Seda -> Ronny Graham
Corey Parker -> Matt Mulhern -> Virginia Madsen
Jimmy Bennett -> Allison Janney -> Margo Martindale
Sean Hayes -> Jason Robards -> Marsha Mason
John Goodman -> Holly Hunter -> Brad Johnson
Ron Howard -> Paul Le Mat -> Charles Martin Smith
Jon Heder -> Danny Masterson -> Karl Malden
Maureen Stapleton -> Barbra Streisand -> Jerry O'Connell
Bob Feller -> Brooks Robinson -> Earl Weaver
John Cassavetes -> Bob Balaban -> Miguel Sandoval
Persia White -> Massimo Troisi -> Rachel Ward
John Savage -> Kimberly Elise -> Gabriela Oltean
Paul Bagget -> Lenore Banks -> Todd Allen
Karen Black -> Richard McConnell -> Sudie Bond
Olga Bellin -> Zev Godinger -> Robert Ellenstein
Michael Forest -> Paul Mazursky -> Matt Trusch
Jean-Michel Richaud -> Craig Barnett -> Daniel Allen Butler
Steven Biel -> Steve Blasco -> Sarah Michelle Gellar
Ryan Phillippe -> Odile Le Clezio -> Jim Holt
Ross McGregor -> Elizabeth Tulloch -> Sarah Sutherland
David Dastmalchian -> Liv Tyler -> William Hurt
Jim Haynie -> Cynthia Gibb -> Robert Picardo
Andrew McCarthy -> Estelle Getty -> Kim Cattrall
Andie MacDowell -> Imogen Stubbs -> Mandy Patinkin
Jordan Christopher -> Eileen Heckart -> George Rose
Christina Ricci -> Nick Swardson -> Christopher Meloni
Freddie Highmore -> Odeya Rush -> Andrea Martin
Liam Hess -> Richard Banel -> Willem Dafoe
Mae Whitman -> Tony Jay -> Wilford Brimley
Michael Ealy -> James Le Gros -> Dori Mizrahi
Jada Pinkett Smith -> Neve Campbell -> Ron Eldard
Joe Mantegna -> Everett Burrell -> Pasquale Buba
Peter Grunwald -> Samantha Mathis -> Patrick Fabian
Esai Morales -> Spanky Taylor -> Joyce Van Patten
Kate McNeil -> John Pankow -> Reg Jans
Julian Sands -> Pamela Salem -> John Hurt
Ricardo Palacios -> Gerardo Giacinti -> Penelope Cruz
Jero Garcia -> Richard Bohringer -> Richard Berry
Farid Chopel -> Fred Gwynne -> Corbin Bernsen
Isaac Delgado -> Celia Cruz -> Willie Colon
Emma Thompson -> Rosa Isabel Lorenzo -> Abner Benaim
Roberto Duran -> Cheo Feliciano -> Tego Calderon
Cultura Profetica -> Johnny Pacheco -> Marc Anthony
Yanfourd -> Jordan Gelber -> Anne Heche
Joan Chen -> Sean Astin -> Celia Weston
Jason Lee -> Janice Karman -> Ross Bagdasarian Jr.
Zachary Levi -> Justin Long -> Bruce Taylor
Bob Odenkirk -> Leon Lamar -> Zoe Axelrod
Shelley Berman -> Michael Chiklis -> James Brolin
Laura Harring -> Sheryl Lee -> Alan Smyth
Sean Pertwee -> David Heap -> JR Bourne
Chyler Leigh -> Tom Berenger -> Connor Hill
David Edney -> Doug Kier -> David Eisner
Rebecca Jenkins -> Stevie Vallance -> Christian Doermer
Calvin Lockhart -> Genevieve Waite -> Lucy Gutteridge
Ned Beatty -> Ruth Gordon -> Joanna Pacula
Jamie Lee Curtis -> William Baldwin -> Lolita Davidovich
Brendan Fraser -> Sally Kellerman -> Sarah Lind
Kristine Cofsky -> Sonja Bennett -> Carmen Lavigne
Stephen Lobo -> Mike Dopud -> Brad Dryborough
Arabella Bushnell -> Ryan Robbins -> Seregon O'Dassey
Jaime Zevallos -> Franco Nero -> Shane Perdue
Matt Servitto -> Robert Mitchum -> Bo Derek
Jeff Fahey -> Chris Lemmon -> Peter Scolari
Brian Klugman -> Gary Lundy -> Kim Murphy
Michael Zelniker -> Amy Parks -> Max Kasch
Maury Chaykin -> Sadie Frost -> Angela Gots
Angela Little -> Zach McGowan -> Tracey Ullman
Lochlyn Munro -> O'Neal Compton -> Max Beesley
Herbert Russell -> Tommy J. Michaels -> Scott Schiaffo
Billy Hine -> Steve Jasgur -> Chandra West
Donna D'Errico -> Charles Dance -> Gary Farmer
Dan Wooster -> Mads Koudal -> Christopher Harrison
Doug Lennox -> David Hemblen -> James Allodi
Taylor Schilling -> Peter Mooney -> Jackson Robert Scott
Anita Mally -> Christian Kohlund -> Susanne Uhlen
Vera Borek -> Toni Bohm -> Rudolf Wessely
Hans Kraus -> Helmuth Lohner -> Eric P. Caspar
Marlene Jobert -> Stefan Wigger -> Zalman Lebiush
Willy Leyrer -> Ellen Schwiers -> Barbara Frey
Katharina Mayberg -> Birgit Doll -> Brent Fidler
Richard Keats -> Mackenzie Gray -> Danny Trejo
Casey Manderson -> Paul Bae -> Valerie Tian
Dermot Mulroney -> Amy Price-Francis -> Kaitlyn Bernard
Dylan Schmid -> Molly Parker -> Ron Perlman
Gummaluri Sastri -> Sivamani -> David O'Hara
Dexter Fletcher -> Finn Wittrock -> Sarah Bolger
Finn Wolfhard -> Piotr Fronczewski -> Helen Sjoholm
Jan Josef Liefers -> Alicia Vikander -> Noah Bystrom
Richard Attenborough -> Sonia Mbele -> Luthuli Dlamini
Adam Scott -> Naomie Harris -> Josh Hartnett
Arnold Schwarzenegger -> Gabriel Byrne -> Kevin Pollak
Cherry Jones -> William Mapother -> Rory Culkin
Justin Chambers -> Emily Browning -> Adam Horovitz
Shannen Doherty -> Josh Peck -> Camila Morrone
Emily Blunt -> Leanne Rowe -> Merilee Brasch
Matt Marraccini -> Cameron Monaghan -> Mckenna Grace
Ellen Barkin -> Tom Selleck -> Rachel Brennock
Sean Barrett -> Tony Aitken -> Maggie Wright
Margaret Burton -> Bartlett Mullins -> Kay Adrian
Peggy Ann Clifford -> Ralph Morgan -> Etienne Girardot
Robert Montgomery -> Reginald Owen -> Helen Vinson
Robert Benchley -> Franchot Tone -> Myrna Loy
Walter Pidgeon -> Brian Aherne -> Jack Carson
Alison Skipworth -> Paul Lukas -> Donald Cook
Betsy Blair -> Melvyn Douglas -> Sid Caesar
Ronald Colman -> Claudette Colbert -> Victor McLaglen
Willard Parker -> Alan Dinehart -> Garrett Brawith
Peter Alsop -> Susan Angelo -> Kathy Najimy
Alaina Reed-Hall -> Lucy Goncalves -> Scott Robinson
Tichina Arnold -> Pierre Perea -> Senait Ashenafi
Antwan Mills -> N'Bushe Wright -> Christopher Amitrano
Graham Beckel -> Tara Buck -> Trudy Marshall
Charles Russell -> Douglass Dumbrille -> Kay Scott
Ann Doran -> Paul Kelly -> Ben Cooper
Colleen Miller -> Audie Murphy -> Frank Ferguson
Olga San Juan -> Mary Hatcher -> Jean-Pierre Jeunet
Stephen Quay -> Guy Maddin -> Liliana Cavani
Bernardo Bertolucci -> Catherine Breillat -> Jan Sodderland
Hente Sodderland -> Sophie Robinson -> Andre B. Blake
Patrick Van Horn -> Heather McComb -> Adrian Grenier
Jerry Ferrara -> Kevin Dillon -> Coolio
Ethan Suplee -> Merle Kennedy -> Anoja Weerasinghe
Chris Haywood -> Eva Sitteova -> Daniel Gelin
Jean Claudio -> Heinz Drache -> Jean-Louis Trintignant
Yves Montand -> Francois Perier -> Maury Colow
Ruth Davidow -> Sam Gonshak -> Erik Darling
Leon Bibb -> Holly Near -> Erica Leerhsen
Kurt Loder -> Stephen Barker Turner -> Michael T. Ringer
Petra Wright -> Gina Philips -> Colleen Werthmann
Timothy Wheeler -> Kevin Pinassi -> Chris Gartin
Jennifer Coolidge -> Oliver Hudson -> Keram Malicki-Sanchez
Emily Bergl -> Mia Kirshner -> Meredith Monroe
Marc Blucas -> Bijou Phillips -> Mischa Barton
Julie McCullough -> Erin O'Brien -> Jessica Morris
Adrian Paul -> Ram Dass -> Alyssa Maria App
Ashley Gerasimovich -> Danni Wang -> Vivian Wu
Lisa Lu -> Joe Lando -> Dwayne Johnson
Roland Moller -> Yanee Tramoth -> Chantavit Dhanasevi
Thawat Pornrattanaprasert -> Somlek Sakdikul -> Patchara Buranawimolwan
Saruth Chatchawan -> Mario Maurer -> Nattapong Chartpong
Davika Hoorne -> Nittha Jirayungyurn -> Nuengthida Sophon
Maneerat Kham-uan -> Siraphan Wattanajinda -> Panissara Phimpru
Rattanrat Eertaweekul -> Sirat Intarachote -> Patcha Poonpiriya
Preechaya Pongthananikorn -> Bonnie Zellerbach -> Popetorn Soonthornyanakij
Puttachat Pongsuchat -> Nalintip Permpattarasakul -> Ananda Everingham
Truong Ngoc Anh -> Andy On -> Lily Ji
Petar Bachvarov -> Zachary Baharov -> Mimoza Bazova
Dolph Lundgren -> Mariah Bonner -> Jean-Claude Van Damme
Takayuki Suzuki -> Yuri Morishita -> Tomoko Kato
Kiss Konishi -> Haruka Ayase -> Todd Jensen
Tsuyoshi Ihara -> David Essex -> Sho Kosugi
Christopher Lee -> Mithuna -> Prajin
Lakana Wattanawongsiri -> Phoomjai Tangsanga -> Kett Thantup
Chaleumpol Tikumpornteerawong -> Sura Theerakon -> Sakrat Ruekthamrong
Nat Tephadsadin Na Ayutthaya -> Chaiyapol Jullian Poupart -> Ratklao Amaradit
Sho Nishino -> Yayaying Rhatha Phongam -> Bongkoj Khongmalai
Petchtai Wongkamlao -> Sakaojai Poonsawat -> Sulile Kumar
Niveditha -> M.S. Bhaskar -> Pongsak Pongsuwan
Sarawut Phumthong -> Note Chern-Yim -> Apichej Kittikornjaroen
Supatchaya Reunreung -> Dan Worrawech -> Pisamai Wilaisak
Kom Chauncheun -> Khwannapa Reuangsri -> Visa Sarasas
Somphong Kunapratom -> Kohtee Aramboy -> Duangrudee Boonbumroong
Cheathavuth Watcharakhun -> Anant Boonnark -> Paula Taylor
Somchai Samipak -> Christian Lee -> Celeste Lim
Cindy Ng -> Garrett Hoo -> Ray MacDonald
Athip Nana -> Choomporn Theppitak -> Thiti Phum-Orn
Al Ameen Saeleema -> Sorapong Chatree -> Po Pao Pee
Artit Wiboonpanitch -> Arpa Pawilai -> Boonyisa Jantrarachai
Sarunyu Prachakrit -> Chanana Nutakom -> Narubet Jinpinpetch
Paweena Chariffsakul -> Naiyana Maneetes -> Anchalee Chaisiri
Pumwaree Yodkamol -> Tony Jaa -> Channarong Khuntee-tao
Somjai Sukjai -> Sonthaya Chitmanee -> Hiroyuki Kobayashi
Surachai Chantimatorn -> Yasuhiko Miyauchi -> Oranate D. Caballes
Nitit Warayanon -> Nadech Kugimiya -> Julaluck Ismalone
Don Ferguson -> Max Casella -> Naomi Watts
Bobby Cannavale -> Caitlin Carmichael -> Garret Dillahunt
Shea Whigham -> Romeo Miller -> Gregg Sulkin
Dallas Lovato -> Ioan Gruffudd -> Chandler Riggs
Natalie Martinez -> Patrick Schwarzenegger -> Quinn Shephard
Rob Riggle -> Simone Labarga -> Jessie T. Usher
Will Brill -> Byron L. Hopkins -> Shane Graham
Lorenzo Richelmy -> Jenny Cooper -> Kian Lawley
Robbie Amell -> Taylor John Smith -> Halston Sage
Nash Grier -> Gregory Alan Williams -> Edy Ganem
Lou Diamond Phillips -> Arnar Jonsson -> Matt O'Leary
Gunnar Helgason -> William Forsythe -> James Badge Dale
Ethan Embry -> James B. Harris -> David Spodak
Kirk Douglas -> Edward Asner -> Jorge Ameer
Lance Alspaugh -> Rosalie Michaels -> Cavin Gray
Shane Dean -> Aundre Caraway -> Stan Babola
Lawrence Hervey -> Lauri Hendler -> Judy Norton
Colin Bird -> Lee Majors -> Stefanie Powers
Helynn Castro -> Christopher Studenka -> Morgan Jacobs
Tori Osborn -> Lori Petty -> Michael Boatman
Erich Anderson -> Kaine Alozie -> Buzz Aldrin
Andrew Alozie -> Leland Burnett -> Dane Reade
Brenda Galilee Rhodes -> George Buza -> Zoe De Grand Maison
Rob Archer -> Carl Bressler -> Eric McCormack
Rafer Weigel -> Allyson Ames -> Eloise Hardt
Woody Strode -> Lieux Dressler -> Tiffany Bolling
Robert Charroux -> Jeane Dixon -> Max H. Flindt
Scott Rinker -> Julianne Christie -> Harry Hamlin
Daryn Tufts -> Chris Clark -> Lisa Clark
Malcolm McDowell -> Robert Emhardt -> Beverly Lunsford
Frank Maxwell -> Colleen Dewhurst -> Bill Moseley
Morena Baccarin -> Joe Perrino -> Caprice Benedetti
Rhiann Woodyard -> Joy Michele -> Robby Daniels
Jeffrey Lee Hollis -> Ray Hanna -> Patrick Pumpuang
John Fraser -> Anthony Quayle -> Donald Houston
Gil Bellows -> Parker Posey -> Kevin McDonald
Benjamin Ratner -> Elizabeth Berkley -> Jay Brazeau
Phyllis Calvert -> Ralph Richardson -> Robert Morley
Patrick Newell -> Philip Stone -> Gabriella Licudi
Leslie Hope -> Alberto Tejada -> Carlos Roberto Majul
Ana Sobero -> Aramis Knight -> Melissa Benoist
Greg Germann -> Melinda Hall -> Bob Burns
Jennifer Blaire -> Larry Blamire -> Ray Appleton
Mackenzie Astin -> Izabella Miko -> Jeremy Piven
Nick Cassavetes -> Brenda Bakke -> Curtis Armstrong
Ran Barker -> Wendy Baker -> Tony Amendola
Jenna Bailey -> James Black -> Shelley Andagan
Mel Braxton -> Bre Blair -> Elizabeth Lesser
Jennifer Turner -> Ayden Clay -> Andra Eggleston
Maud Schuyler Clay -> Bernie Worrell -> Alex Weir
Steven Scales -> Michael Beckwith -> Julia Decker
Shohreh Aghdashloo -> Denise Brown -> Russell Simmons
Anthony Holds -> Greg Hansen -> John Jenis
Daniel Passaro -> Noam Chomsky -> Douglas Rushkoff
Laurie Williams -> Karamea Davis -> Miranda Adams
Keith Stewart -> Kate Bush -> Joan Armatrading
Chet Atkins -> Vittorio Gassman -> Doris Dowling
Silvana Mangano -> Barry Sullivan -> Efrem Zimbalist Jr.
Ginger Rogers -> Angela Lansbury -> Carol Lynley
Carroll Baker -> Red Buttons -> Maria Pia Casilio
Jacques Duby -> Lionel Friedberg -> Joseph Tomelty
Odile Versois -> David Knight -> Suzy Kendall
Rod Taylor -> Ahna Capri -> Carina Helm
Donald Gray -> John Bentley -> Adrienne Scott
Oskar Wegrostek -> Lauren Bacall -> Jeffrey Lyons
Tamara Brooks -> Shura Lipovsky -> Merima Kljuco
Curd Jurgens -> John Banner -> David Hedison
Cary Grant -> Frank Sinatra -> Sophia Loren
Anna Massey -> Andrew Ray -> Glynis Johns
Noel Purcell -> Inia Te Wiata -> Alec Guinness
Anthony Steel -> Muriel Pavlow -> Hugh Williams
Corinne Calvet -> Diane Baker -> Fred Clark
Ed Wasser -> Grace Zabriskie -> Tracy Nelson
Patti Cohoon-Friedman -> Sam Hennings -> Raymond Cruz
Tony Dow -> Brad Dourif -> Casey Kasem
Russ Tamblyn -> Lana Wood -> Joseph Schildkraut
Shelley Winters -> Millie Perkins -> Luciano Berriatua
Adriano Apra -> Joao Benard da Costa -> Michel Ciment
Gian Piero Brunetta -> Michal Docolomansky -> Vaclav Lohnisky
Rudolf Hrusinsky -> Frantisek Filipovsky -> Jaromir Hanzlik
Libuse Safrankova -> Rudolf Deyl -> Karel Fiala
Kveta Fialova -> Daniela Kolarova -> Karel Anderle
Sandra Milo -> Marcello Mastroianni -> Chris Marker
Bob Castella -> Jean-Luc Godard -> Reginald Kernan
Alexandra Stewart -> Marcello Pagliero -> Yvonne Lombard
Gunnar Bjornstrand -> Eva Dahlbeck -> Carl Lange
Maria Sebaldt -> Helmut Griem -> Herman Ahlsell
Carl Billquist -> Gertrud Fridh -> Alexander Skarsgard
Ju-hee Park -> Robert Jelinek -> Hyeon Ju
Jin-mo Ju -> Min-sik Choi -> Stefan Norrthon
Do-yeon Jeon -> Mi-seon Hwang -> Goran Cederberg
Matti Oravisto -> Claude Titre -> Douglas Hage
Sven Lindberg -> Orson Welles -> Sylva Koscina
Laurence Harvey -> Mona Malm -> Thomas Svanfeldt
Zbigniew Cybulski -> Isa Quensel -> 

Will Smith -> Wild Wild West -> Wild Wild West
Wild Wild West -> Kevin Kline -> A Midsummer Night's Dream
A Midsummer Night's Dream -> Darling Companion -> Darling Companion
Darling Companion -> French Kiss -> French Kiss
French Kiss -> He Makes Me Feel Like Dancin' -> He Makes Me Feel Like Dancin'
He Makes Me Feel Like Dancin' -> Princess Caraboo -> Princess Caraboo
Princess Caraboo -> Silverado -> Silverado
Soapdish -> Soapdish -> Soapdish
Sophie's Choice -> Sophie's Choice -> Sophie's Choice
The Conspirator -> The Conspirator -> The Conspirator
The Emperor's Club -> The Emperor's Club -> The January Man
Theater of War -> Kenneth Branagh -> How to Kill Your Neighbor's Dog
How to Kill Your Neighbor's Dog -> Mary Shelley's Frankenstein -> Mary Shelley's Frankenstein
Mary Shelley's Frankenstein -> Othello -> Othello
Othello -> Sleuth -> Sleuth
Sleuth -> The Gingerbread Man -> The Gingerbread Man
The Goebbels Experiment -> The Theory of Flight -> The Theory of Flight
Salma Hayek -> Rupert Everett -> Chronicle of a Death Foretold
Chronicle of a Death Foretold -> Chronicle of a Death Foretold -> Inspector Gadget
Inspector Gadget -> Inspector Gadget -> Michelle Pfeiffer
The Prince of Egypt -> The Prince of Egypt -> The Prince of Egypt
To Gillian on Her 37th Birthday -> To Gillian on Her 37th Birthday -> To Gillian on Her 37th Birthday
Dianne Wiest -> A Guide to Recognizing Your Saints -> A Guide to Recognizing Your Saints
Bullets Over Broadway -> Bullets Over Broadway -> Bullets Over Broadway
Cookie -> Cookie -> Cookie
Cops and Robbersons -> Cops and Robbersons -> Cops and Robbersons
Edward Scissorhands -> Edward Scissorhands -> Edward Scissorhands
Five Nights in Maine -> Five Nights in Maine -> Footloose
Footloose -> Footloose -> Radio Days
Radio Days -> Radio Days -> The Horse Whisperer
The Horse Whisperer -> Diane Keaton -> Annie Hall
Annie Hall -> Annie Hall -> Baby Boom
Baby Boom -> Baby Boom -> Harry and Walter Go to New York
Harry and Walter Go to New York -> Manhattan -> Manhattan
Marvin's Room -> The Godfather Part III -> The Godfather Part III
The Only Thrill -> The Only Thrill -> Town & Country
Town & Country -> Town & Country -> Richard Jenkins
A Goldfish of the Flame -> A Goldfish of the Flame -> Bone Tomahawk
Bone Tomahawk -> Bone Tomahawk -> Dear John
Dear John -> Dear John -> Eddie
Eddie -> Eddie -> Lullaby
Lullaby -> Lullaby -> The Indian in the Cupboard
The Mudge Boy -> The Mudge Boy -> The Mudge Boy
Untitled Miranda July Project -> Untitled Miranda July Project -> Untitled Miranda July Project
Meg Ryan -> Addicted to Love -> Addicted to Love
My Mom's New Boyfriend -> My Mom's New Boyfriend -> My Mom's New Boyfriend
Jean Reno -> Godzilla -> Timothy Hutton
Judy Collins -> Woody Guthrie: Hard Travelin' -> Woody Guthrie: Hard Travelin'
Woody Guthrie: Hard Travelin' -> Woody Guthrie: Hard Travelin' -> Woody Guthrie: Hard Travelin'
Tom McCaffrey -> Jacques d'Amboise -> Wendy Hughes
Phoebe Cates -> Bodies, Rest & Motion -> Bodies, Rest & Motion
Bodies, Rest & Motion -> Jim Broadbent -> Kevin Costner
3 Days to Kill -> 3 Days to Kill -> 3 Days to Kill
3000 Miles to Graceland -> 3000 Miles to Graceland -> JFK
JFK -> Laffit: All About Winning -> Robin Hood: Prince of Thieves
Robin Hood: Prince of Thieves -> Scott Glenn -> Vertical Limit
Vertical Limit -> Vertical Limit -> Sally Field
Steel Magnolias -> Teri Hatcher -> Cathy Moriarty
Meryl Streep -> Mamma Mia! Here We Go Again -> Mamma Mia! Here We Go Again
The House of the Spirits -> Peter MacNicol -> Rita Karin
Robin Wright -> The Singing Detective -> The Singing Detective
Toys -> Toys -> Toys
Tom Wilkinson -> James McAvoy -> It Chapter Two
It Chapter Two -> It Chapter Two -> Embeth Davidtz
Bicentennial Man -> Feast of July -> Junebug
Junebug -> Murder in the First -> Nag van die 19de
Nag van die 19de -> Nag van die 19de -> Simon Magus
Simon Magus -> Simon Magus -> Joel Gretsch
Saving Grace B. Jones -> Saving Grace B. Jones -> Saving Grace B. Jones
Harvey Keitel -> Fingers -> Fingers
Tony Kushner -> Lynn Redgrave -> Suzi Hofrichter
Helena Bonham Carter -> Alice Through the Looking Glass -> Alice Through the Looking Glass
Robert De Niro -> Goodfellas -> Goodfellas
Goodfellas -> Tom Hulce -> Fearless
Fearless -> Wings of Courage -> Wings of Courage
Irene Jacob -> Laurence Fishburne -> Hoodlum
The Matrix -> The Matrix -> The Matrix
Nathaniel Parker -> Michael Caine -> Ashanti
Ashanti -> Ashanti -> California Suite
California Suite -> California Suite -> Going in Style
Going in Style -> Hannah and Her Sisters -> Mona Lisa
My Generation -> My Generation -> My Generation
My Generation -> My Generation -> My Generation
My Generation -> Secondhand Lions -> Secondhand Lions
Secondhand Lions -> The Cider House Rules -> The Muppet Christmas Carol
The Muppet Christmas Carol -> The Muppet Christmas Carol -> The Wilby Conspiracy
The Wilby Conspiracy -> The Wilby Conspiracy -> Jude Law
Sherlock Holmes -> Sherlock Holmes -> Harold Pinter
Robert Downey Jr. -> 1969 -> 1969
1969 -> A Scanner Darkly -> Captain America: Civil War
Captain America: Civil War -> Captain America: Civil War -> Chances Are
Chances Are -> Chances Are -> Chaplin
Chaplin -> Eros -> Eros
I Am Steve McQueen -> I Am Steve McQueen -> Only You
Only You -> Only You -> Restoration
Restoration -> Spider-Man: Homecoming -> Spider-Man: Homecoming
The Avengers -> The Judge -> Tropic Thunder
Tropic Thunder -> Tropic Thunder -> Two Girls and a Guy
Two Girls and a Guy -> Two Girls and a Guy -> Zodiac
Zodiac -> Daryl Hannah -> 2047: Sights of Death
Centaur -> Memoirs of an Invisible Man -> Ole
Ole -> Ole -> Roxanne
Roxanne -> Roxanne -> Splash
Splash -> Splash -> The Carbon Rush
Your American Teen -> Your American Teen -> Your American Teen
Udo Samel -> Gemma Jones -> Holly Aird
Irene Papas -> Beyond the Mountains -> Beyond the Mountains
Beyond the Mountains -> Island -> Island
Island -> Witness Out of Hell -> Witness Out of Hell
Witness Out of Hell -> Z -> Z
Z -> Gian Maria Volonte -> Ornella Muti
Matthew Broderick -> Biloxi Blues -> Biloxi Blues
Biloxi Blues -> Diminished Capacity -> Diminished Capacity
Lazy Susan -> Lazy Susan -> Lazy Susan
Max Dugan Returns -> Max Dugan Returns -> Max Dugan Returns
Mrs. Parker and the Vicious Circle -> Mrs. Parker and the Vicious Circle -> The Night We Never Met
The Night We Never Met -> The Night We Never Met -> The Road to Wellville
The Stepford Wives -> The Stepford Wives -> The Stepford Wives
Michelle Trachtenberg -> Joely Fisher -> Val Kilmer
Hard Cash -> Hard Cash -> Sandra Bullock
Gun Shy -> Gun Shy -> Speed
Speed -> The Prime Ministers: The Pioneers -> The Prime Ministers: The Pioneers
Ralph Fiennes -> Quiz Show -> Quiz Show
Quiz Show -> Peter Gallagher -> Dreamchild
Dreamchild -> Dreamchild -> Everybody Just Stay Calm
Everybody Just Stay Calm -> Everybody Just Stay Calm -> Everybody Just Stay Calm
House on Haunted Hill -> House on Haunted Hill -> House on Haunted Hill
Johnny Skidmarks -> Johnny Skidmarks -> Protection
Protection -> Sundance Skippy -> Sundance Skippy
Sundance Skippy -> Sundance Skippy -> Sundance Skippy
Sundance Skippy -> The Man Who Knew Too Little -> The Man Who Knew Too Little
The Man Who Knew Too Little -> The War Boys -> The War Boys
The War Boys -> Watch It -> Watch It
Watch It -> Claire Danes -> Little Women
Laurie Fortier -> Rosario Dawson -> Alexander
Alexander -> Light It Up -> Light It Up
Light It Up -> The First $20 Million Is Always the Hardest -> The First $20 Million Is Always the Hardest
The First $20 Million Is Always the Hardest -> Trance -> Trance
Unforgettable -> Unforgettable -> Shia LaBeouf
Honey Boy -> Honey Boy -> Indiana Jones and the Kingdom of the Crystal Skull
Indiana Jones and the Kingdom of the Crystal Skull -> Indiana Jones and the Kingdom of the Crystal Skull -> Lawless
Lawless -> Lawless -> Man Down
Man Down -> The Battle of Shaker Heights -> The Battle of Shaker Heights
The Greatest Game Ever Played -> The Greatest Game Ever Played -> The Greatest Game Ever Played
Transformers -> Transformers -> Transformers
Wall Street: Money Never Sleeps -> Wall Street: Money Never Sleeps -> John Cusack
1408 -> 1408 -> 1408
Breakfast with Hunter -> Breakfast with Hunter -> One Crazy Summer
One Crazy Summer -> One Crazy Summer -> Pushing Tin
The Journey of Natty Gann -> The Journey of Natty Gann -> The Journey of Natty Gann
Chazz Palminteri -> Final Recourse -> Final Recourse
Final Recourse -> The Oogieloves in the Big Balloon Adventure -> The Oogieloves in the Big Balloon Adventure
The Oogieloves in the Big Balloon Adventure -> Jennifer Tilly -> Pass the Sugar
Pass the Sugar -> Pass the Sugar -> Pass the Sugar
Pass the Sugar -> Saint Ralph -> Saint Ralph
Emily Lloyd -> Chicago Joe and the Showgirl -> Chicago Joe and the Showgirl
In Country -> In Country -> In Country
Scorchers -> Scorchers -> Scorchers
The Honeytrap -> The Honeytrap -> Under the Hula Moon
Under the Hula Moon -> When Saturday Comes -> When Saturday Comes
When Saturday Comes -> Wish You Were Here -> Wish You Were Here
Wish You Were Here -> Woundings -> Woundings
Peter Falk -> Cops n Roberts -> Cops n Roberts
Cops n Roberts -> Cops n Roberts -> Cops n Roberts
Cops n Roberts -> Faraway, So Close! -> Faraway, So Close!
Faraway, So Close! -> Lakeboat -> Lakeboat
Lakeboat -> The Secret of the Purple Reef -> The Secret of the Purple Reef
The Secret of the Purple Reef -> The Thing About My Folks -> The Thing About My Folks
Michael V. Gazzo -> Alligator -> Alligator
Border Cop -> Border Cop -> Border Cop
Nothing to Lose -> Nothing to Lose -> Nothing to Lose
Nothing to Lose -> Nothing to Lose -> Robert Davi
Cyber Vengeance -> Cyber Vengeance -> Cyber Vengeance
The Dukes -> The Dukes -> Jack Palance
Attack -> Attack -> Battle of the Commandos
Hawk the Slayer -> Hawk the Slayer -> Hawk the Slayer
The Lonely Man -> The Lonely Man -> The Lonely Man
The Spy in the Green Hat -> The Spy in the Green Hat -> The Spy in the Green Hat
Chevy Chase -> Wishin' and Hopin' -> Wishin' and Hopin'
Anthony Michael Hall -> Aftermath -> Aftermath
Exit in Red -> Exit in Red -> Exit in Red
The Photographer -> The Photographer -> Winona Ryder
Black Swan -> Black Swan -> Homefront
Homefront -> Homefront -> Homefront
Homefront -> Homefront -> Lost Souls
Lost Souls -> Lost Souls -> Night on Earth
Night on Earth -> Night on Earth -> The Iceman
The Private Lives of Pippa Lee -> The Ten -> The Ten
The Ten -> Welcome Home, Roxy Carmichael -> Welcome Home, Roxy Carmichael
Johnny Depp -> Benny & Joon -> Benny & Joon
From Hell -> Hope and Healing Award Concert -> Hope and Healing Award Concert
Hope and Healing Award Concert -> Hope and Healing Award Concert -> Private Resort
Rango -> Rango -> Rango
Teyonah Parris -> A Picture of You -> A Picture of You
A Picture of You -> Chi-Raq -> Dear White People
Dear White People -> Dear White People -> If Beale Street Could Talk
Love Under New Management: The Miki Howard Story -> Love Under New Management: The Miki Howard Story -> Love Under New Management: The Miki Howard Story
Where Children Play -> Where Children Play -> Where Children Play
Rosie Perez -> Fugly! -> Fugly!
Fugly! -> It Could Happen to You -> It Could Happen to You
King of the Jungle -> King of the Jungle -> The 24 Hour Woman
The 24 Hour Woman -> The 24 Hour Woman -> Untamed Heart
Kevin Bacon -> Elephant White -> Elephant White
Elephant White -> Loverboy -> New York Skyride
New York Skyride -> New York Skyride -> Songs to Keep: Treasures of an Adirondack Folk Collector
Songs to Keep: Treasures of an Adirondack Folk Collector -> Songs to Keep: Treasures of an Adirondack Folk Collector -> Telling Lies in America
Telling Lies in America -> Lori Singer -> John Lithgow
Homegrown -> Homegrown -> Shrek
Shrek -> The World According to Garp -> Mike Starr
Dumb and Dumber -> Making a Killing -> Man with Van
Man with Van -> Mancation -> Mancation
Tempted -> Tempted -> Tempted
ThE F3aR -> ThE F3aR -> ThE F3aR
Walk a Mile in My Pradas -> Walk a Mile in My Pradas -> Walk a Mile in My Pradas
Mia Farrow -> Paul Herman -> Terrified
Sam Neill -> Blackbird -> Blackbird
Colin McCahon: I Am -> Dead Calm -> Dead Calm
Possession -> Possession -> Possession
The Adventurer: The Curse of the Midas Box -> The Adventurer: The Curse of the Midas Box -> The Adventurer: The Curse of the Midas Box
Kristin Scott Thomas -> Darkest Hour -> Force majeure
Force majeure -> Force majeure -> In the House
In the House -> In the House -> Le bal du gouverneur
Le bal du gouverneur -> Le bal du gouverneur -> Salmon Fishing in the Yemen
Salmon Fishing in the Yemen -> Sarah's Key -> Sarah's Key
Sarah's Key -> The Heir Apparent: Largo Winch -> The Heir Apparent: Largo Winch
The Heir Apparent: Largo Winch -> Up at the Villa -> Up at the Villa
Woody Allen -> Tony Roberts -> Carol Kane
The Shrink Is In -> The Shrink Is In -> Sam Shepard
Defenseless -> Harry Dean Stanton: Partly Fiction -> Harry Dean Stanton: Partly Fiction
Harry Dean Stanton: Partly Fiction -> Kristina Kennedy -> Harold Ramis
James Caan -> Elliott Gould -> Michael Murphy
Kansas City -> Kansas City -> Mariel Hemingway
Leonardo DiCaprio -> Don's Plum -> Don's Plum
Andy Garcia -> Al Pacino -> Robert Patrick
Diane Lane -> Warren Beatty -> Nastassja Kinski
Goldie Hawn -> Swing Shift -> Derek Deadman
Tony Devon -> Kurt Russell -> Dark Blue
Dark Blue -> Dark Blue -> Death Proof
Dreamer: Inspired by a True Story -> Dreamer: Inspired by a True Story -> Guns of Diablo
Miracle -> Miracle -> Miracle
Stargate -> Stargate -> Stargate
Patrick Wilson -> Zipper -> Zipper
Matthew Fox -> Extinction -> Extinction
Extinction -> Henry Thomas -> Briar Patch
Briar Patch -> Briar Patch -> Niagara, Niagara
Niagara, Niagara -> Channing Tatum -> Amanda Seyfried
Frank Langella -> Whoopi Goldberg -> Dennis Farina
Paparazzi -> Paparazzi -> The Grand
The Grand -> The Grand -> Jessica Brown Findlay
Anne Archer -> Garrett Hedlund -> Litefoot
Pablo Schreiber -> Tom Guiry -> Emile Hirsch
The Motel Life -> The Motel Life -> The Motel Life
Gina Rodriguez -> Diana Maria Riva -> Evan Rachel Wood
Tcheky Karyo -> Kelly Preston -> Selma Blair
A Dirty Shame -> A Guy Thing -> A Guy Thing
A Guy Thing -> Cruel Intentions -> Cruel Intentions
Cruel Intentions -> Dark Horse -> Kill Me Later
Kill Me Later -> Kill Me Later -> Strong Island Boys
Strong Island Boys -> The Broccoli Theory -> The Broccoli Theory
The Broccoli Theory -> The Deal -> The Deal
Antonio Banderas -> Shrek Forever After -> The Mask of Zorro
The Mask of Zorro -> Colin Hanks -> Maria Pitillo
Ronnie Gilbert -> Forever Activists: Stories from the Veterans of the Abraham Lincoln Brigade -> Forever Activists: Stories from the Veterans of the Abraham Lincoln Brigade
Forever Activists: Stories from the Veterans of the Abraham Lincoln Brigade -> Isn't This a Time! A Tribute Concert for Harold Leventhal -> Isn't This a Time! A Tribute Concert for Harold Leventhal
The Women of Summer -> Arlo Guthrie -> Alice's Restaurant
Alice's Restaurant -> Joan Baez -> Jack Elliott
Hoyt Axton -> Disorganized Crime -> Disorganized Crime
Disorganized Crime -> Tim Roth -> Backsliding
Backsliding -> Backsliding -> Chronic
Chronic -> Chronic -> Rosencrantz & Guildenstern Are Dead
The Incredible Hulk -> The Incredible Hulk -> The Incredible Hulk
Bridget Fonda -> Little Buddha -> Little Buddha
Eric Stoltz -> Hailee Steinfeld -> Connie Nielsen
Amber Heard -> Christian Slater -> Alone in the Dark
Alone in the Dark -> Beyond the Stars -> Beyond the Stars
Beyond the Stars -> Dawn Rider -> Dawn Rider
Gleaming the Cube -> Gleaming the Cube -> Jimmy Hollywood
Jimmy Hollywood -> The Name of the Rose -> The Name of the Rose
Way of the Wicked -> Way of the Wicked -> Way of the Wicked
Who Is Cletis Tout? -> Who Is Cletis Tout? -> Courteney Cox
Blue Desert -> Cocoon: The Return -> November
November -> November -> Scream 2
Scream 2 -> The Runner -> The Runner
The Runner -> Walter Matthau -> Jack Lemmon
Laffit Pincay Jr. -> Morgan Freeman -> Mary Elizabeth Mastrantonio
Robin Tunney -> August -> August
August -> End of Days -> End of Days
End of Days -> Julian Po -> My All-American
My All-American -> My All-American -> Supernova
The Secret Lives of Dentists -> The Zodiac -> The Zodiac
The Zodiac -> Chris O'Donnell -> Bill Paxton
Olympia Dukakis -> Leonard Soloway's Broadway -> Leonard Soloway's Broadway
Moonstruck -> Never Too Late -> Never Too Late
The Cemetery Club -> The Cemetery Club -> The Golden Greek: The Harry Agganis Story
The Golden Greek: The Harry Agganis Story -> Lily James -> Broken
Broken -> Broken -> Broken
Broken -> National Theatre Live: All About Eve -> National Theatre Live: All About Eve
National Theatre Live: All About Eve -> National Theatre Live: All About Eve -> National Theatre Live: All About Eve
National Theatre Live: All About Eve -> National Theatre Live: All About Eve -> Pride and Prejudice and Zombies
Pride and Prejudice and Zombies -> Pride and Prejudice and Zombies -> The Exception
The Exception -> Yesterday -> Yesterday
Yesterday -> Cher -> Jeremy Irons
Jeremy Northam -> Mel Gibson -> Robin Williams
Aladdin -> Aladdin -> Aladdin
Cadillac Man -> Cadillac Man -> Cadillac Man
Certifiably Jonathan -> Certifiably Jonathan -> Certifiably Jonathan
Club Paradise -> Club Paradise -> Club Paradise
Dead Poets Society -> Dead Poets Society -> Death to Smoochy
Death to Smoochy -> Good Will Hunting -> Good Will Hunting
Jumanji -> Man of the Year -> Man of the Year
Night at the Museum: Secret of the Tomb -> Night at the Museum: Secret of the Tomb -> One Hour Photo
One Hour Photo -> Seize the Day -> Seize the Day
Seize the Day -> What Dreams May Come -> What Dreams May Come
Michael Gambon -> Joan Cusack -> Bill Skarsgard
It -> Moomins and the Winter Wonderland -> Simon & the Oaks
Simon & the Oaks -> The Crown Jewels -> The Crown Jewels
Villains -> Jessica Chastain -> A Most Violent Year
A Most Violent Year -> Sophia Lillis -> Oliver Platt
Ready to Rumble -> Ready to Rumble -> Year One
Zig Zag -> James Purefoy -> Fisherman's Friends
Fisherman's Friends -> Fisherman's Friends -> Interlude in Prague
Interlude in Prague -> Jilting Joe -> Jilting Joe
Jilting Joe -> Photo Finish -> Photo Finish
Photo Finish -> Alicia Van Couvering -> Alessandro Nivola
$5 a Day -> Best Laid Plans -> Carolina
Carolina -> Coco Before Chanel -> Coco Before Chanel
Coco Before Chanel -> Face/Off -> Goal II: Living the Dream
Goal II: Living the Dream -> I Want You -> I Want You
I Want You -> Reach the Rock -> Reach the Rock
The Art of Self-Defense -> The Art of Self-Defense -> The Art of Self-Defense
Gary Oldman -> Marcel van Heerden -> Pierre Knoesen
You Must Be Joking Too! -> You Must Be Joking Too! -> You Must Be Joking Too!
Pieter Brand -> Stuart Townsend -> About Adam
About Adam -> About Adam -> Chaos Theory
Queen of the Damned -> Queen of the Damned -> Queen of the Damned
Resurrection Man -> Resurrection Man -> Resurrection Man
Shooting Fish -> Shooting Fish -> Shooting Fish
The Escort -> The Escort -> The League of Extraordinary Gentlemen
The League of Extraordinary Gentlemen -> Trojan Eddie -> Trojan Eddie
Trojan Eddie -> Noah Taylor -> Flirting
Flirting -> Life in the Fast Lane -> Life in the Fast Lane
Life in the Fast Lane -> Submarine -> Submarine
The Double -> The Nostradamus Kid -> The Nostradamus Kid
The Nostradamus Kid -> True Love and Chaos -> Sean McGinley
On a Clear Day -> On a Clear Day -> On a Clear Day
Penelope Ann Miller -> Michael Biehn -> Tatum O'Neal
Jim Brown -> Directors on Directing 2: The Story of the Storytellers -> Directors on Directing 2: The Story of the Storytellers
Directors on Directing 2: The Story of the Storytellers -> Tisa Farrow -> Mia Wasikowska
Anne Hathaway -> Joe Pesci -> Easy Money
Easy Money -> Easy Money -> Gone Fishin'
Gone Fishin' -> Gone Fishin' -> My Cousin Vinny
My Cousin Vinny -> The Death Collector -> The Death Collector
The Death Collector -> The Death Collector -> The Death Collector
The Public Eye -> The Public Eye -> The Super
The Super -> Ray Liotta -> Lorraine Bracco
Isabella Rossellini -> Jeff Bridges -> Jagged Edge
Elizabeth McGovern -> Craig Sheffer -> Flypaper
Vanessa Williams -> Keanu Reeves -> Flying
Flying -> Flying -> Replicas
Replicas -> Replicas -> Side by Side Extra: Volume Five
Side by Side Extra: Volume Five -> Side by Side Extra: Volume Two -> Side by Side Extra: Volume Two
Side by Side Extra: Volume Two -> The Night Before -> The Night Before
The Night Before -> Hugo Weaving -> Carrie-Anne Moss
Peter Ustinov -> Kabir Bedi -> Beverly Johnson
Jane Fonda -> Maggie Smith -> Alan Alda
Ann-Margret -> Alan Arkin -> Barbara Hershey
Falling Down -> Love Comes Lately -> Love Comes Lately
Cathy Tyson -> Alexandra Kosasie -> Mary Quant
David Bailey -> Arya Vasco -> Bryan Warow
Lutesha -> Twiggy -> Kyra Sedgwick
Big Sky -> Big Sky -> Big Sky
Critical Care -> Critical Care -> Labor Pains
Labor Pains -> Reach Me -> Reach Me
Robert Duvall -> Hotel Colonial -> Hotel Colonial
Hotel Colonial -> John Q -> John Q
John Q -> The Apostle -> The Apostle
The Apostle -> The Outfit -> Tomorrow
Tomorrow -> Tomorrow -> Haley Joel Osment
Almost Friends -> Almost Friends -> Almost Friends
Bogus -> Edges of the Lord -> Edges of the Lord
Edges of the Lord -> The Jungle Book 2 -> The Jungle Book 2
Tobey Maguire -> Dave Goelz -> Jerry Nelson
Steve Whitmire -> Nicol Williamson -> Prunella Gee
Sidney Poitier -> The Slender Thread -> Rachel McAdams
Mark Strong -> Kiefer Sutherland -> Mariette Hartley
Bruce Dern -> The Cake Eaters -> Rory Cochrane
Scarlett Johansson -> Hitchcock -> Chris Evans
Sebastian Stan -> Mary Stuart Masterson -> Cybill Shepherd
Ryan O'Neal -> Paul Rhys -> The Strange Case of Delfina Potocka: The Mystery of Chopin
The Strange Case of Delfina Potocka: The Mystery of Chopin -> The Strange Case of Delfina Potocka: The Mystery of Chopin -> The Strange Case of Delfina Potocka: The Mystery of Chopin
The Strange Case of Delfina Potocka: The Mystery of Chopin -> Geraldine Chaplin -> Chen Chang
Li Gong -> Zoe Bell -> Kristin Kreuk
Marisa Tomei -> Bonnie Hunt -> Joaquim de Almeida
David Thewlis -> Polly Walker -> Tom Holland
Michael Keaton -> Jeremy Renner -> Vera Farmiga
Love in the Time of Money -> Love in the Time of Money -> Jeff Kahn
Jack Black -> Ben Stiller -> Heather Graham
Angel David -> Natasha Gregson Wagner -> Anthony Edwards
Jake Gyllenhaal -> Proof -> Michael Madsen
Sheryl Crow -> Michael McKean -> Massimo Boldi
Enzo Salvi -> Vincenzo Salemme -> Rick Rossovich
Shelley Duvall -> Steve Martin -> Tom Hanks
Eugene Levy -> John Candy -> Karine Vanasse
Jane Velez-Mitchell -> Elizabeth Gould Delmatoff -> Ron Wyden
Maximilian Schell -> Five Finger Exercise -> Five Finger Exercise
Five Finger Exercise -> Labyrinth -> Labyrinth
Labyrinth -> The Deadly Affair -> The Deadly Affair
The Deadly Affair -> You Can't Live Like That -> You Can't Live Like That
Raf Vallone -> Bitter Rice -> Bitter Rice
Bitter Rice -> Harlow -> Harlow
Harlow -> Harlow -> Harlow
Harlow -> Harlow -> The Adultress
The Adultress -> Theodore Bikel -> A Sacred Duty
Chance Meeting -> Chance Meeting -> Chance Meeting
Darker Than Amber -> Darker Than Amber -> Darker Than Amber
Escape from the Iron Curtain -> Escape from the Iron Curtain -> Escape from the Iron Curtain
Escape from the Iron Curtain -> Escape from the Iron Curtain -> Humphrey Bogart: Behind the Legend
Humphrey Bogart: Behind the Legend -> Journey 4 Artists -> Journey 4 Artists
Journey 4 Artists -> The Blue Angel -> The Blue Angel
The Enemy Below -> The Pride and the Passion -> The Pride and the Passion
The Pride and the Passion -> Anoja Weerasinghe -> Chris Haywood
Eva Sitteova -> Daniel Gelin -> Jean Claudio
Heinz Drache -> Jean-Louis Trintignant -> Yves Montand
Francois Perier -> Christopher Walken -> Wayne's World 2
Wild Side -> Wild Side -> Corey Parker
Matt Mulhern -> Virginia Madsen -> Jimmy Bennett
Allison Janney -> The Duff -> Margo Martindale
Sean Hayes -> Donald Sutherland -> A War Story
A War Story -> Joanna -> Joanna
Joanna -> The Trouble with Spies -> The Trouble with Spies
The Trouble with Spies -> Virus -> Virus
Virus -> Younger and Younger -> Younger and Younger
Younger and Younger -> Jason Robards -> Marsha Mason
Campbell Scott -> Crashing -> Crashing
Duma -> Duma -> Stolen
Stolen -> Stolen -> Jennifer Jason Leigh
Amityville: The Awakening -> Amityville: The Awakening -> Palindromes
Annabella Sciorra -> Tim Guinee -> Jeanne Tripplehorn
Anthony Hopkins -> Bobby -> Bobby
Hearts in Atlantis -> Hearts in Atlantis -> Solace
Solace -> The Dawning -> The Dawning
The Human Stain -> The Human Stain -> The Lion in Winter
The Lion in Winter -> Glenn Close -> What I Want My Words to Do to You: Voices from Inside a Women's Maximum Security Prison
What I Want My Words to Do to You: Voices from Inside a Women's Maximum Security Prison -> What I Want My Words to Do to You: Voices from Inside a Women's Maximum Security Prison -> Nicole Kidman
Bette Midler -> Sara Downing -> Burning Annie
Burning Annie -> Burning Annie -> Rats
Rats -> The Grift -> The Grift
Vincent Laresca -> Empire -> Empire
Jose Zuniga -> Liam Neeson -> Dennis Hopper
Joe Morton -> Leonard Nimoy -> Carpati: 50 Miles, 50 Years
Deathwatch -> Deathwatch -> Deathwatch
Hava Nagila: The Movie -> Hava Nagila: The Movie -> Minyan in Kaifeng
My Brother Vincent -> Star Trek II: The Wrath of Khan -> Star Trek II: The Wrath of Khan
The Story of Computer Graphics -> Titanica -> Titanica
Titanica -> Zambezia -> Zambezia
Michael Douglas -> Coma -> Coma
Rob Morrow -> Atlas Shrugged: Who Is John Galt? -> Going Shopping
Going Shopping -> Into My Heart -> Little Loopers
Rehearsal -> Rehearsal -> Rehearsal
The Good Doctor -> The Good Doctor -> The Good Doctor
Paul Scofield -> John Turturro -> Ian Holm
Caris Corfman -> Coral Browne -> Martin Scorsese
Hank Blumenthal -> Whit Stillman -> Mira Sorvino
Famke Janssen -> Taye Diggs -> Geoffrey Rush
Frances McDormand -> Friends with Money -> Promised Land
Promised Land -> John Kapelos -> Cold Blooded
Cold Blooded -> Cold Blooded -> Everybody Wants to Be Italian
Everybody Wants to Be Italian -> Everybody Wants to Be Italian -> The Boost
Stephen Baldwin -> Aron Tager -> Brittany Flickinger
Zooey Deschanel -> Minnie Driver -> Ben Affleck
Michael Cera -> Rob Corddry -> Sex Tape
Sex Tape -> Richard Wilson -> Joanne Whalley
Bill Murray -> Benjamin Walker -> Brian J. Smith
Victor Rasuk -> Jon Tenney -> John C. McGinley
Suzy Amis -> Kirsten Dunst -> Small Soldiers
Small Soldiers -> Angelina Jolie -> Colin Farrell
Robert Ri'chard -> Forest Whitaker -> Usher Raymond
Jake Busey -> Enrico Colantoni -> Adam Garcia
Vincent Cassel -> Danny Sapani -> Katherine Heigl
Isabella Kai -> Laura San Giacomo -> Natasha Lyonne
Krippendorf's Tribe -> Cate Blanchett -> Harrison Ford
The Mosquito Coast -> The Mosquito Coast -> Karen Allen
Jason Clarke -> Tom Hardy -> Guy Pearce
Kate Mara -> Jai Courtney -> Anson Mount
Amy Smart -> Stephen Dillane -> James Paxton
Elias Koteas -> Josh Duhamel -> Tyrese Gibson
Megan Fox -> Carey Mulligan -> Josh Brolin
Tony Shalhoub -> Samuel L. Jackson -> Mary McCormack
Alex Cox -> Douglas Brinkley -> Linda Warren
Demi Moore -> G.I. Jane -> Joel Murray
Billy Bob Thornton -> Chrystal -> Chrystal
Chrystal -> Friday Night Lights -> Friday Night Lights
Friday Night Lights -> Mr. Woodcock -> Mr. Woodcock
Parkland -> Parkland -> Parkland
Sling Blade -> Sling Blade -> The Alamo
The Alamo -> The Alamo -> The Informers
The Informers -> The Man Who Wasn't There -> The Man Who Wasn't There
Meredith Salenger -> Lainie Kazan -> Ray Wise
Lucas Elliot Eberl -> Teri Polo -> Tia Carrere
Jaime Pressly -> Cloris Leachman -> Christopher Lloyd
Mike Matusow -> Jose Canseco -> Mike Sexton
Joe Hachem -> James Woods -> Michael Kanev
Adam Butcher -> Liz Fraser -> John Lahr
Bruce Willis -> Color of Night -> Color of Night
RED -> Kevin Anderson -> Joan Allen
Faye Dunaway -> James Earl Jones -> Denholm Elliott
Stuart McQuarrie -> Anthony Green -> Chris Penn
Musetta Vander -> Pete Postlethwaite -> Craig Kelly
Sean Bean -> Essex Boys -> Barbara Durkin
Clare Clifford -> Trudi Cavanagh -> Charlie Creed-Miles
Sammi Davis -> Arlene Golonka -> Priscilla Barnes
Stephen Furst -> Dody Goodman -> Don Calfa
Herb Edelman -> Horst Buchholz -> Bruno Ganz
Otto Sander -> Denis Leary -> Charles Durning
Robert Forster -> Margia Dean -> Jeff Richards
Richard Chamberlain -> Elizabeth Perkins -> Paul Reiser
Dean Jagger -> Sister Kenny -> Sister Kenny
Robin Riker -> Eddie Albert -> Telly Savalas
Danny De La Paz -> Paul Gleason -> Youssef Abed-Alnour
Alexandra Paul -> David Campbell -> Juliano Mer-Khamis
J. Gregory Smith -> Matthias Hues -> Josh Mosby
Peter Bogdanovich -> Frank D'Amico -> Robert Strauss
Lee Marvin -> The Raid -> The Raid
Thomas Hunter -> Bernard Bresslaw -> Ray Charleson
John Terry -> Neville Brand -> Anthony Perkins
Robert Middleton -> Janet Leigh -> Night of the Lepus
Night of the Lepus -> Robert Vaughn -> David McCallum
Conchata Ferrell -> Molly Ringwald -> Tony Danza
Jamie Harrold -> Annabel Schofield -> Hank Garrett
Mickey Rourke -> Reg Rogers -> Marisa Berenson
Natalie Portman -> Mila Kunis -> Brenda Jo Reutebuch
Timothy Paul Taylor -> Jason Statham -> James Franco
Michael Loos -> Kate Bosworth -> Philip Baker Hall
Sarah Wynter -> Ben Chaplin -> Gena Rowlands
Lisanne Falk -> Alan Randolph Scott -> Michael Shannon
Mike Binder -> Jessica Alba -> The Veil
The Veil -> Paul Rudd -> Adam Brody
Jeff Daniels -> Laila Robins -> Julianne Moore
Aidan Quinn -> Robbie Coltrane -> Dave Kushner
Dave Navarro -> Chester Bennington -> Mark McGrath
Emily Longstreth -> Abigail Breslin -> Timothy Olyphant
Isla Fisher -> Andrew Pang -> Lucas Dixon
Jo Mei -> Angela Bassett -> Waiting to Exhale
Waiting to Exhale -> Kyle Gallner -> Tyler James Williams
Tessa Thompson -> Regina King -> Gary Dourdan
Amari Cheatom -> Darius McCrary -> Macy Gray
Brian White -> Leon -> John Leguizamo
Radha Mitchell -> Griffin Dunne -> Nicolas Cage
Wendell Pierce -> Julie Carmen -> Cliff Gorman
Patti LuPone -> Karen Duffy -> Marianne Jean-Baptiste
Kyle Secor -> Markus Waldow -> Final Recipe
Mr. Hurt -> Mr. Hurt -> Mr. Hurt
Mr. Hurt -> Ninja: Shadow of a Tear -> Ninja: Shadow of a Tear
Ninja: Shadow of a Tear -> The Rooms -> The Rooms
The Rooms -> The Rooms -> Djimon Hounsou
Jirantanin Pitakporntrakul -> Brawl -> Brawl
Brawl -> Brawl -> Brawl
Brawl -> Brawl -> Dominic Scott Kay
James Doohan -> Actors in War -> Actors in War
Actors in War -> The Duke -> The Duke
The Duke -> Michael Harkins -> Elya Baskin
Wheelmen -> Wheelmen -> N. Paul Stookey
Pete Seeger -> Dear Governor Cuomo -> Dear Governor Cuomo
Latido Latino II: tiempos mestizos -> Pete & Toshi Get a Camera -> Play On, John: A Life in Music
Play On, John: A Life in Music -> Play On, John: A Life in Music -> Play On, John: A Life in Music
Play On, John: A Life in Music -> Play On, John: A Life in Music -> Rooted in Peace
Swim for the River -> The Power of Their Song: The Untold Story of Latin America's New Song Movement -> The Power of Their Song: The Untold Story of Latin America's New Song Movement
The Power of Their Song: The Untold Story of Latin America's New Song Movement -> The Power of Their Song: The Untold Story of Latin America's New Song Movement -> The Power of Their Song: The Untold Story of Latin America's New Song Movement
Michael Bacon -> Calista Flockhart -> Brad Renfro
The Client -> The Client -> Kelly Lynch
Mr. Magoo -> Mr. Magoo -> Mr. Magoo
Virtuosity -> Virtuosity -> Hank Azaria
Cameron Diaz -> Mike Myers -> Shrek 2
Mary Beth Hurt -> Chilly Scenes of Winter -> Chilly Scenes of Winter
Chilly Scenes of Winter -> Interiors -> Parents
Parents -> Slaves of New York -> Slaves of New York
Slaves of New York -> Lauren Holly -> Entropy
Entropy -> Jude Moran -> Laura Fraser
Ursula Parker -> Matt Kawczynski -> Danica McKellar
Burt Reynolds -> Saffron Burrows -> Randy Austin
Peter Evangelista -> Saul Stein -> Joe Blute
Tom Arnold -> Tom Archdeacon -> Nathaniel Marston
Lisa Zane -> Bex Taylor-Klaus -> Kate Winslet
Paul Casserly -> Rod Mullinar -> Billy Zane
Margit Carstensen -> Isabelle Adjani -> Heinz Bennent
Aneurin Barnard -> Lena Headey -> Michael Sheen
Ben Mendelsohn -> Francois Cluzet -> Patrick Bruel
Alan Bates -> Fabrice Luchini -> Vincent Schmitt
Ernst Umhauer -> Laurent Grevill -> Didier Flamand
Jacques Sereys -> Amr Waked -> Ewan McGregor
Frederic Pierrot -> Melusine Mayance -> Niels Arestrup
Predrag 'Miki' Manojlovic -> Melanie Thierry -> Tomer Sisley
James Fox -> Thoroughly Modern Millie -> Sean Penn
David Arquette -> David James Elliott -> J.T. Walsh
David Lynch -> Celluloid Dreams -> Celluloid Dreams
Celluloid Dreams -> Great Directors -> Great Directors
Great Directors -> My Beautiful Broken Brain -> My Beautiful Broken Brain
My Beautiful Broken Brain -> Harry Dean Stanton -> Kris Kristofferson
Harry Belafonte -> Miranda Richardson -> Kevin Connolly
Devious Beings -> Devious Beings -> Devious Beings
Entourage -> Entourage -> Entourage
Tyrone -> Tyrone -> Tyrone
Scott Bloom -> Christine Lahti -> Whose Life Is It Anyway?
Whose Life Is It Anyway? -> Ving Rhames -> Piranha 3D
Piranha 3D -> Scott Speedman -> Michael Michele
Vanessa Ferlito -> Dakota Fanning -> Oded Fehr
Jan Merlin -> Nathan West -> Noah Emmerich
Patricia Clarkson -> James Spader -> Jack's Back
Jack's Back -> Jack's Back -> Mannequin
Mannequin -> Mannequin -> Sex, Lies, and Videotape
True Colors -> True Colors -> Jaye Davidson
Viveca Lindfors -> Richard Dreyfuss -> Always
Always -> American Graffiti -> American Graffiti
American Graffiti -> Killing Winston Jones -> Killing Winston Jones
Nuts -> Nuts -> Nuts
Signs of the Time -> Signs of the Time -> Signs of the Time
Ray Winstone -> Jeffrey Donovan -> Book of Shadows: Blair Witch 2
Book of Shadows: Blair Witch 2 -> Book of Shadows: Blair Witch 2 -> Sam & Joe
Sam & Joe -> Sam & Joe -> Throwing Down
Throwing Down -> Throwing Down -> Quinn McColgan
Clara Lago -> Dominique Swain -> As Virgins Fall
As Virgins Fall -> As Virgins Fall -> Happy Campers
Happy Campers -> New Best Friend -> New Best Friend
Stuntmen -> Tart -> Tart
The Dark Field -> The Dark Field -> The Dark Field
The Fast and the Fierce -> Arie Verveen -> James Urbaniak
Stephen Lang -> Michael Parks -> Cole Hauser
Daniel Baldwin -> David Cross -> Alvin and the Chipmunks
Alvin and the Chipmunks -> Alvin and the Chipmunks: The Squeakquel -> Alvin and the Chipmunks: The Squeakquel
Demoted -> Demoted -> Run Ronnie Run
Run Ronnie Run -> Run Ronnie Run -> The Legend of Secret Pass
The Legend of Secret Pass -> The Legend of Secret Pass -> Woody Harrelson
The Sunchaser -> The Sunchaser -> Cheryl Hines
Stephen Dorff -> Backbeat -> Botched
Botched -> Botched -> Brake
Brake -> Brake -> Bucky Larson: Born to Be a Star
Bucky Larson: Born to Be a Star -> Bucky Larson: Born to Be a Star -> Carjacked
Nancy Youngblut -> Doc Divecchio -> Tracey Ullman
Jason Lee -> Julia Stiles -> James Brolin
Reese Witherspoon -> Sarah Michelle Gellar -> Ryan Phillippe
Jordan Gelber -> Lochlyn Munro -> O'Neal Compton
Max Beesley -> Herbert Russell -> Tommy J. Michaels
Scott Schiaffo -> Billy Hine -> Steve Jasgur
Robert Loggia -> Snapshot -> Snapshot
Snapshot -> Colm Feore -> A Perfect Son
Intervention -> Intervention -> Intervention
Six Reasons Why -> Six Reasons Why -> Six Reasons Why
The Herd -> The Herd -> The Herd
The Prodigy -> The Prodigy -> The Prodigy
Eddie Murphy -> Catherine Zeta-Jones -> Jose Maria de Tavira
Maury Colow -> Ruth Davidow -> Sam Gonshak
Erik Darling -> Leon Bibb -> Holly Near
Patricia Quinn -> Fall from Innocence -> Fall from Innocence
Fall from Innocence -> Fall from Innocence -> Mary Horror
Mary Horror -> Mary Horror -> Shock Treatment
Shock Treatment -> Shoot Out -> Shoot Out
Shoot Out -> The Outsider -> The Outsider
The Outsider -> Zachariah -> Zachariah
James Broderick -> The Tree -> The Tree
The Tree -> Ruben Blades -> From Son to Salsa
From Son to Salsa -> From Son to Salsa -> Imagining Argentina
Invasion -> Invasion -> Invasion
Sono, Sono, Tite Curet!!! -> Sono, Sono, Tite Curet!!! -> Sono, Sono, Tite Curet!!!
Spoken Word -> Spoken Word -> Yo soy la Salsa
Yo soy la Salsa -> Yo soy la Salsa -> Fred Gwynne
Corbin Bernsen -> Odile Le Clezio -> Jim Holt
Ross McGregor -> Elizabeth Tulloch -> Sarah Sutherland
David Dastmalchian -> Livio Badurina -> Edward Norton
Liv Tyler -> William Hurt -> Ruocheng Ying
Chris Isaak -> Tara Reid -> Frank C. Turner
Family Reunion -> Family Reunion -> Family Reunion
Martin Sheen -> Sharon Stone -> Robert Foxworth
Ben Cotton -> In No Particular Order -> In No Particular Order
In No Particular Order -> In No Particular Order -> In No Particular Order
In No Particular Order -> The Cabin Movie -> The Cabin Movie
The Cabin Movie -> Jill Hennessy -> If I Had Wings
If I Had Wings -> If I Had Wings -> Lost in Time
Lost in Time -> Lost in Time -> Lost in Time
Lost in Time -> Lost in Time -> Lymelife
The Acting Class -> The Acting Class -> The Acting Class
Steven Bauer -> Heartlines -> Heartlines
The Versace Murder -> The Versace Murder -> The Versace Murder
Woman of Desire -> Woman of Desire -> Woman of Desire
Richard Herd -> Corporate Affairs -> Corporate Affairs
Jason Beghe -> An Experiment in Fear: The Making of Monkey Shines -> An Experiment in Fear: The Making of Monkey Shines
An Experiment in Fear: The Making of Monkey Shines -> Atlas Shrugged II: The Strike -> Atlas Shrugged II: The Strike
Atlas Shrugged II: The Strike -> Going Clear: Scientology & the Prison of Belief -> Monkey Shines
Monkey Shines -> Monkey Shines -> Survivors of Malmedy: December 1944
Victoria Abril -> After Darkness -> After Darkness
After Darkness -> Comin' at Ya! -> Don't Tempt Me
Don't Tempt Me -> Don't Tempt Me -> L'addition
L'addition -> L'addition -> Sean Connery
Franco Cristaldi e il suo cinema Paradiso -> Franco Cristaldi e il suo cinema Paradiso -> Franco Cristaldi e il suo cinema Paradiso
Never Say Never Again -> Shalako -> Shalako
Helmut Qualtinger -> Abelard -> Abelard
Abelard -> Das Diarium des Dr. Doblinger -> Das Diarium des Dr. Doblinger
Das Diarium des Dr. Doblinger -> Der Paukenspieler -> Der Paukenspieler
Der Paukenspieler -> Grandison -> Krankensaal 6
Krankensaal 6 -> Krankensaal 6 -> Mann im Schatten
Mann im Schatten -> Mann im Schatten -> Tales from the Vienna Woods
Emily Tennant -> Poe: Last Days of the Raven -> Poe: Last Days of the Raven
Poe: Last Days of the Raven -> Vinnie Jones -> Throwdown
Jake Croker -> The Lonely Light of Home -> The Lonely Light of Home
The Lonely Light of Home -> Portia de Rossi -> Tim Allen
D.B. Sweeney -> Wilford Brimley -> Michael Ealy
James Le Gros -> Dori Mizrahi -> Jada Pinkett Smith
Neve Campbell -> Skyscraper -> Skyscraper
John Goodman -> Ron Eldard -> Joe Mantegna
Adam Scott -> Naomie Harris -> Josh Hartnett
Arnold Schwarzenegger -> Gabriel Byrne -> Kevin Pollak
Cherry Jones -> Aaron Eckhart -> Finn Wittrock
Sarah Bolger -> Peter Facinelli -> Hope Davis
Disconnect -> Disconnect -> Disconnect
Rebel in the Rye -> Rebel in the Rye -> Rebel in the Rye
William Mapother -> Rory Culkin -> Justin Chambers
Tovah Feldshuh -> Charlie Hoboken -> Charlie Hoboken
Charlie Hoboken -> Cheaper to Keep Her -> Cheaper to Keep Her
The Idolmaker -> The Tollbooth -> Triangle: Remembering the Fire
Triangle: Remembering the Fire -> Triangle: Remembering the Fire -> Elizabeth Ashley
Danny Aiello -> Jean Lapointe -> Jan Rubes
Ellen Burstyn -> Diane Ladd -> Johnny Pesky
Curt Gowdy -> Nicholas B. York -> Charlie Booty
S.R. Stevens -> Gian Carlo Bono -> Karl van Allen
Gillian Anderson -> Monica Dolan -> Rhashan Stone
Julian Ovenden -> Sheila Reid -> Ian Drysdale
Stanley Townsend -> Bella Heathcote -> Sam Riley
Jack Huston -> Christopher Plummer -> Lois Alessandra
James Corden -> Ana de Armas -> Kate McKinnon
Linda Larkin -> Jonathan Freeman -> Scott Weinger
Pamela Reed -> Tim Robbins -> Fran Drescher
Jonathan Winters -> Nora Dunn -> Howie Mandel
Peter O'Toole -> Jimmy Cliff -> Rick Moranis
Josh Charles -> Ethan Hawke -> Catherine Keener
Danny DeVito -> Matt Damon -> Stellan Skarsgard
Jonathan Hyde -> Laura Linney -> Lewis Black
Owen Wilson -> Dick Van Dyke -> Michael Vartan
Dylan Smith -> David Bickford -> Glenne Headly
Richard B. Shull -> Max von Sydow -> Cuba Gooding Jr.
Finn Wolfhard -> Piotr Fronczewski -> Helen Sjoholm
Jan Josef Liefers -> Alicia Vikander -> Noah Bystrom
Maika Monroe -> Bokeh -> Bokeh
Bokeh -> Echoes of War -> Echoes of War
Echoes of War -> David Oyelowo -> Oscar Isaac
Bill Goldberg -> Scott Caan -> Olivia Wilde
Wesley Snipes -> Tuppence Middleton -> Daniel Mays
Noel Clarke -> Morfydd Clark -> Samantha Barks
Benjamin Whitrow -> Geraldine Somerville -> Patricia Hodge
Aidan Gillen -> Colette Brown -> Georgina Hale
Dean Cain -> Gene Wolande -> Randy Quaid
Shirley MacLaine -> Benoit Poelvoorde -> Audrey Tautou
Marie Gillain -> John Travolta -> The Punisher
Kuno Becker -> Anna Friel -> Labina Mitevska
Luka Petrusic -> Rachel Weisz -> Karen Sillas
Bruce Norris -> Jesse Eisenberg -> Steve Terada
Imogen Poots -> Eddie Eckstein -> Cobus Rossouw
Leon Schuster -> Frances O'Connor -> Tommy Tiernan
Kate Hudson -> Ryan Reynolds -> Aaliyah
Marguerite Moreau -> Vincent Perez -> Brenda Fricker
George Shane -> David Williamson -> Rowena Cooper
Dan Futterman -> Kate Beckinsale -> Liza Walker
Daniel Auteuil -> Jason Flemyng -> Peta Wilson
Richard Harris -> Aislin McGuckin -> Stephen Rea
Thandie Newton -> Bartholomew Rose -> Fairuza Balk
Patrick Dempsey -> Tea Leoni -> Craig Roberts
Sally Hawkins -> Wallace Shawn -> Peter Gwynne
Arthur Dignam -> Miranda Otto -> Naveen Andrews
Brenda Blethyn -> Peter Mullan -> Billy Boyd
James Avery -> After Romeo -> After Romeo
After Romeo -> Antonia Pantoja Presente! -> Chasing Sunsets
Chasing Sunsets -> Chasing Sunsets -> Dancing in September
Honeybee -> Honeybee -> Honeybee
Restraining Order -> The Grind -> The Grind
The Grind -> Charles Burnett -> Ben Caldwell
Rodney Dangerfield -> Geraldine Fitzgerald -> Candice Azzara
Danny Glover -> Rosanna Arquette -> Lynn Whitfield
Mitchell Whitfield -> Ralph Macchio -> Frank Vincent
Joe Cortese -> Lou Criscuolo -> Keith Davis
Bobby Alto -> Bryan Travis Smith -> Richard Riehle
Madolyn Smith Osborne -> Vincent Gardenia -> Peter Coyote
The Reality of Truth -> Sadie Frost -> Rita Tushingham
Olivia d'Abo -> Jessica Steen -> Thomas Middleditch
John Ortiz -> Alice Eve -> David Tattersall
Michael Ballhaus -> Wally Pfister -> Richard Linklater
Robert Rodriguez -> Lori Loughlin -> Trinidad Silva
Theresa Saldana -> Rachel Ticotin -> Otto Tausig
Rhea Perlman -> Frank Grillo -> Once Upon a Time in Staten Island
Once Upon a Time in Staten Island -> Once Upon a Time in Staten Island -> Wheelman
Wheelman -> Wheelman -> Bella Thorne
Frog Kingdom -> Frog Kingdom -> Frog Kingdom
I Still See You -> I Still See You -> Keep Watching
Keep Watching -> Keep Watching -> Midnight Sun
Midnight Sun -> Midnight Sun -> Ride
Ride -> Ride -> Ride
Ride -> Ride -> Shovel Buddies
Shovel Buddies -> You Get Me -> You Get Me
You Get Me -> Aaron Tveit -> Created Equal
Created Equal -> Created Equal -> Anne Bancroft
The Kid from Left Field -> The Kid from Left Field -> The Kid from Left Field
The Kid from Left Field -> The Restless Breed -> The Restless Breed
The Restless Breed -> The Restless Breed -> To Be or Not to Be
Helen Mirren -> Calendar Girls -> Calendar Girls
The Hundred-Foot Journey -> The Hundred-Foot Journey -> The Hundred-Foot Journey
The Madness of King George -> The Nutcracker and the Four Realms -> The Quiz Kid
Mary Tyler Moore -> Lela Rochon -> Lauren Cohan
Thomas Jane -> 1922 -> 1922
1922 -> Dark Country -> Padamati Sandhya Ragam
Padamati Sandhya Ragam -> Stander -> Stander
Massimo Troisi -> Rachel Ward -> John Savage
Denzel Washington -> Kimberly Elise -> Gabriela Oltean
Paul Bagget -> Lenore Banks -> Todd Allen
Karen Black -> Richard McConnell -> Sudie Bond
Olga Bellin -> Christopher Meloni -> Freddie Highmore
Odeya Rush -> Andrea Martin -> Liam Hess
Richard Banel -> Willem Dafoe -> Mae Whitman
Tony Jay -> Steven Hill -> Miriam Shor
Danny Huston -> Penelope Wilton -> Corin Redgrave
John Shrapnel -> Elizabeth McGorian -> Valentina Igoshina
Malcolm Gets -> Domenick Lombardozzi -> Gwyneth Paltrow
Rosalind Russell -> Fast and Loose -> Fast and Loose
Fast and Loose -> Fast and Loose -> Live, Love and Learn
Live, Love and Learn -> Man-Proof -> Man-Proof
Man-Proof -> Rosie! -> Roughly Speaking
The Casino Murder Case -> The Casino Murder Case -> The Casino Murder Case
The Guilt of Janet Ames -> The Guilt of Janet Ames -> The Guilt of Janet Ames
Under Two Flags -> Under Two Flags -> Under Two Flags
What a Woman! -> What a Woman! -> Jack Hawkins
Gideon of Scotland Yard -> Gideon of Scotland Yard -> Land of Fury
Land of Fury -> Land of Fury -> Malta Story
Malta Story -> Malta Story -> The Third Secret
Twice Upon a Time -> Richard Beymer -> Hemingway's Adventures of a Young Man
Hemingway's Adventures of a Young Man -> Hemingway's Adventures of a Young Man -> Home the Horror Story
Home the Horror Story -> Home the Horror Story -> Playing Patti
Playing Patti -> Playing Patti -> Playing Patti
Playing Patti -> Scream Free! -> Scream Free!
Scream Free! -> The Diary of Anne Frank -> The Diary of Anne Frank
The Diary of Anne Frank -> Christopher Chaplin -> Il cinema ritrovato: istruzioni per l'uso
Il cinema ritrovato: istruzioni per l'uso -> Il cinema ritrovato: istruzioni per l'uso -> Il cinema ritrovato: istruzioni per l'uso
Il cinema ritrovato: istruzioni per l'uso -> Milos Kopecky -> Adele's Dinner
Adele's Dinner -> Adele's Dinner -> How to Drown Dr. Mracek, the Lawyer
How to Drown Dr. Mracek, the Lawyer -> How to Drown Dr. Mracek, the Lawyer -> Lemonade Joe
Lemonade Joe -> Lemonade Joe -> Slasti Otce vlasti
Slasti Otce vlasti -> Christian Thuri -> Simone Signoret
Adua e le compagne -> Adua e le compagne -> La solitude du chanteur de fond
La solitude du chanteur de fond -> Le joli mai -> Les mauvais coups
Les mauvais coups -> Les mauvais coups -> Harriet Andersson
A Lesson in Love -> A Lesson in Love -> A Lesson in Love
Barbara - Wild wie das Meer -> Barbara - Wild wie das Meer -> Barbara - Wild wie das Meer
Dream of Happiness -> Dream of Happiness -> Dream of Happiness
Happy End -> Happy End -> Happy End
Happy End -> Happy End -> Happy End
Happy End -> Happy End -> Happy End
Har borjar aventyret -> Har borjar aventyret -> Har borjar aventyret
Hoppsan! -> Hoppsan! -> Kampf um Rom II - Der Verrat
Kampf um Rom II - Der Verrat -> Kampf um Rom II - Der Verrat -> Siska
To Love -> To Love -> To Love
James Mason -> Aleksandr Nevzorov -> Olya Dvoretskaya
Vittorio Gassman -> Doris Dowling -> Silvana Mangano
Barry Sullivan -> Efrem Zimbalist Jr. -> Ginger Rogers
Angela Lansbury -> Carol Lynley -> Carroll Baker
Red Buttons -> Maria Pia Casilio -> Jacques Duby
Lionel Friedberg -> Joseph Tomelty -> Odile Versois
David Knight -> Suzy Kendall -> Rod Taylor
Ahna Capri -> Carina Helm -> Donald Gray
John Bentley -> Adrienne Scott -> Oskar Wegrostek
Lauren Bacall -> Jeffrey Lyons -> Tamara Brooks
Shura Lipovsky -> Merima Kljuco -> Curd Jurgens
John Banner -> David Hedison -> Cary Grant
Frank Sinatra -> Sophia Loren -> Dana Carvey
Anne Heche -> Joan Chen -> Robbie Amell
David Edney -> Doug Kier -> Christian Doermer
Calvin Lockhart -> Genevieve Waite -> Lucy Gutteridge
Ned Beatty -> Ruth Gordon -> Joanna Pacula
Jamie Lee Curtis -> William Baldwin -> Lolita Davidovich
Brendan Fraser -> Sally Kellerman -> Caleigh White
Believers Among Us -> Believers Among Us -> Alex Kingston
Bukowski -> Bukowski -> Bukowski
Warrior Queen -> Warrior Queen -> Mary Makhatho
Meet the Radebes -> Meet the Radebes -> Alex Michaeletos
Harold Smith -> Blythe Danner -> The Love Letter
Anthony Bailey -> Robin Hood Junior -> Robin Hood Junior
Robin Hood Junior -> Sex and the Other Woman -> Sex and the Other Woman
Sex and the Other Woman -> Sex and the Other Woman -> Sex and the Other Woman
Cameron Monaghan -> Mckenna Grace -> Ellen Barkin
Nathalie Madore -> Felixe Ross -> Anton Yelchin
Mika Boorem -> Abbie Cornish -> Jeffrey Dean Morgan
Trevor Howard -> Jean Simmons -> Gary Sinise
Ed Harris -> Katharine Hepburn -> John Castle
Eve Ensler -> Mary Alice -> Hazelle Goodman
Brian Klugman -> Gary Lundy -> Kim Murphy
Michael Zelniker -> Amy Parks -> Max Kasch
Maury Chaykin -> Denise Richards -> Peter Sarsgaard
Zev Godinger -> Robert Ellenstein -> Michael Forest
Paul Mazursky -> Glen Campbell -> Regina Spektor
Matt Trusch -> Jean-Michel Richaud -> William Shatner
A Christmas Horror Story -> A Christmas Horror Story -> A Christmas Horror Story
Free Enterprise -> Free Enterprise -> Free Enterprise
Incubus -> Incubus -> Kingdom of the Spiders
Kingdom of the Spiders -> Kingdom of the Spiders -> Mysteries of the Gods
Mysteries of the Gods -> Mysteries of the Gods -> Shoot or Be Shot
Shoot or Be Shot -> Shoot or Be Shot -> Stalking Santa
Stalking Santa -> Stalking Santa -> Star Trek: Generations
The Intruder -> The Intruder -> The Intruder
The Third Walker -> To Your Last Death -> To Your Last Death
DeForest Kelley -> Beyond Our Own -> Beyond Our Own
Beyond Our Own -> Fear in the Night -> Fear in the Night
Fear in the Night -> Gunfight at Comanche Creek -> Gunfight at Comanche Creek
Gunfight at Comanche Creek -> Variety Girl -> Variety Girl
Variety Girl -> Craig Barnett -> Daniel Allen Butler
Steven Biel -> Steve Blasco -> Jeff Goldblum
Jeremy Suarez -> Rip Torn -> Genevieve Bujold
Laura Regan -> Victoria Foyt -> Lee Grant
Claire Forlani -> Jay R. Ferguson -> Deborah Kara Unger
Bruce Greenwood -> Breanne Hill -> Orlando Bloom
Taraji P. Henson -> Riley Keough -> Jennifer Aniston
John Krasinski -> Hal Holbrook -> Brian Markinson
Kenneth Welsh -> Tony Nardi -> Jay Jablonski
Cerina Vincent -> John Enos III -> Sean Young
Ellie Kemper -> Jason Segel -> Gregory Smith
Jay Mohr -> Jenna Elfman -> Jadrien Steele
River Phoenix -> Viggo Mortensen -> Kamron Ross Stacey
Lisa Blount -> David Rhodes -> Lucas Black
Derek Luke -> Jay Hernandez -> Seann William Scott
Amy Poehler -> Zac Efron -> Paul Giamatti
Tom Welling -> Dwight Yoakam -> John Ritter
Emilio Echevarria -> Jason Patric -> Dennis Quaid
Kim Basinger -> Jon Foster -> Michael Badalucco
James Gandolfini -> Lesley Ann Warren -> Jane March
Mary-Louise Parker -> Golden Exits -> Golden Exits
Gareth Milne -> Alexander Knox -> Philip Merivale
Van Heflin -> Richard Boone -> Stuart Whitman
Rory Calhoun -> Lily Rabe -> Aleksa Palladino
Whitney Houston -> Loretta Devine -> Chin Han
A Different Sun -> A Different Sun -> A Different Sun
Blindness -> Blindness -> Blindness
Pongsatorn Jongwilak -> ATM: Er Rak Error -> ATM: Er Rak Error
ATM: Er Rak Error -> My Space -> My Space
My Space -> Pee Mak -> Pee Mak
Pee Mak -> Mashannoad Suvalmas -> Marie Broenner
Sunny Suwanmethanont -> A Gift -> A Gift
Dear Dakanda -> Dear Dakanda -> Dear Dakanda
Die Tomorrow -> Die Tomorrow -> Die Tomorrow
I Fine..Thank You Love You -> I Fine..Thank You Love You -> I Fine..Thank You Love You
I Fine..Thank You Love You -> Shambala -> Shambala
Scott Adkins -> Abduction -> Abduction
Abduction -> El Gringo -> El Gringo
El Gringo -> Universal Soldier: Day of Reckoning -> Universal Soldier: Day of Reckoning
Universal Soldier: Day of Reckoning -> Mika Hijii -> ...And Love
...And Love -> ...And Love -> ...And Love
Akko's Secret -> Ninja -> Ninja
Kane Kosugi -> Journey of Honor -> Journey of Honor
Journey of Honor -> Yoko Takano -> Savika Chaiyadej
100 Percent Love Aata -> 100 Percent Love Aata -> Chum thaang rot fai phii
Chum thaang rot fai phii -> Chum thaang rot fai phii -> Chum thaang rot fai phii
Chum thaang rot fai phii -> Jan Dara: The Beginning -> Jan Dara: The Finale
Jan Dara: The Finale -> Jan Dara: The Finale -> Jan Dara: The Finale
Jan Dara: The Finale -> Jan Dara: The Finale -> Love Slave
Love Slave -> Markandeyan -> Markandeyan
Markandeyan -> The Holy Man -> The Holy Man
The Holy Man -> Kavee Tanjararak -> Omen
Omen -> Omen -> Omen
Ponglang Amazing Theater -> Ponglang Amazing Theater -> Ponglang Amazing Theater
Ponglang Amazing Theater -> Ponglang Amazing Theater -> Ponglang Amazing Theater
Sexphone & the Lonely Wave -> Sexphone & the Lonely Wave -> Sexphone & the Lonely Wave
Sexphone & the Lonely Wave -> Ase Wang -> Clouds in My Coffee
Clouds in My Coffee -> Clouds in My Coffee -> Clouds in My Coffee
Jakkrit Kanokpodjananon -> Suchao Pongwilai -> Ameen
Ameen -> Ameen -> Ameen
Ameen -> Citizen II -> Citizen II
Distortion -> Distortion -> Distortion
Distortion -> Distortion -> Kor Kwam Rak Bang Dai Mai
Kor Kwam Rak Bang Dai Mai -> Kor Kwam Rak Bang Dai Mai -> Mae Luek Kerd Dai
Ong-Bak: The Thai Warrior -> Ong-Bak: The Thai Warrior -> Yom-Pee-Poa
Yom-Pee-Poa -> Yuhkoh Matsuguchi -> Anthony Ryu
Khun Phan -> Sunset at Chaophraya -> Sunset at Chaophraya
Sunset at Chaophraya -> Sunset at Chaophraya -> Sunset at Chaophraya
Sunset at Chaophraya -> Jay Morin -> Jawed El Berni
David Ismalone -> Mystic Blade -> Mystic Blade
Joseph Wapner -> Richard Anderson -> Anatomy of a Film
Anatomy of a Film -> Anatomy of a Film -> Classic Hollywood Cinemas
Classic Hollywood Cinemas -> Classic Hollywood Cinemas -> Deadfall Trail
Deadfall Trail -> Deadfall Trail -> Fable
Fable -> Fable -> Nowhere to Hide
Nowhere to Hide -> Nowhere to Hide -> Secret of Bigfoot
Secret of Bigfoot -> The Deadbeats -> The Deadbeats
The Deadbeats -> The Deadbeats -> The Glass Shield
The Glass Shield -> The Glass Shield -> When the World Breaks
When the World Breaks -> When the World Breaks -> Richard Kline
Knight to F4 -> Knight to F4 -> Knight to F4
Courtnee Draper -> The Immaculate Misconception -> The Immaculate Misconception
The Prodigy -> The Prodigy -> The Prodigy
The Prodigy -> The Prodigy -> The Prodigy
John Neville -> A Study in Terror -> A Study in Terror
A Study in Terror -> Dinner at Fred's -> Dinner at Fred's
Dinner at Fred's -> Moving Malcolm -> Moving Malcolm
Moving Malcolm -> Oscar Wilde -> Oscar Wilde
Oscar Wilde -> Unearthly Stranger -> Unearthly Stranger
Unearthly Stranger -> Water Damage -> Jeremy Maxwell
Jim Beaver -> Ah! Silenciosa -> Ah! Silenciosa
Ah! Silenciosa -> Billy Boy -> Billy Boy
Billy Boy -> Cooties -> Dark and Stormy Night
Dark and Stormy Night -> Dark and Stormy Night -> Remember the Sultana
Remember the Sultana -> The Frontier -> Twogether
Twogether -> Twogether -> Lisa Arturo
Border to Border -> Border to Border -> Border to Border
One More Round -> One More Round -> One More Round
Stripped Down -> Stripped Down -> Stripped Down
Natalie Merchant -> Paradise Is There -> Paradise Is There
Joan Osborne -> David Byrne -> By the Ways: A Journey with William Eggleston
By the Ways: A Journey with William Eggleston -> By the Ways: A Journey with William Eggleston -> Stop Making Sense
Stop Making Sense -> Stop Making Sense -> Mika Seeger
John Cohen -> Rayna Gellert -> Ray Alden
Bruce Molsky -> Dick Connette -> Sonya Cohen
Deepak Chopra -> Change Is Gonna Come -> Change Is Gonna Come
Change Is Gonna Come -> Change Is Gonna Come -> Urban Sutra
Christopher Swain -> Roy Brown -> Danny and the Lions
Danny and the Lions -> Danny and the Lions -> Reality Check: The Musical
Robert De Cormier -> Jackson Browne -> American Music: Off the Record
American Music: Off the Record -> Song of the Kauri -> Song of the Kauri
Song of the Kauri -> Song of the Kauri -> The Secret Policeman's Third Ball
The Secret Policeman's Third Ball -> The Secret Policeman's Third Ball -> Lichi Fuentes
Tao Rodriguez-Seeger -> Susan Sarandon -> Tommy Lee Jones
Matt Keeslar -> Leslie Nielsen -> Nick Chinlund
Stephen Spinella -> Russell Crowe -> Julie Andrews
Peter Riegert -> John Heard -> Kenneth McMillan
Kristin Griffith -> Bryan Madorsky -> Sandy Dennis
Chris Sarandon -> Adam Coleman Howard -> Bernadette Peters
Judith Godreche -> Kelly Macdonald -> Carol Channing
Jean-Pierre Jeunet -> Stephen Quay -> Guy Maddin
Liliana Cavani -> Bernardo Bertolucci -> Catherine Breillat
Jan Sodderland -> Hente Sodderland -> Sophie Robinson
Andre B. Blake -> Patrick Van Horn -> Heather McComb
Adrian Grenier -> Jerry Ferrara -> Kevin Dillon
Coolio -> Ethan Suplee -> Merle Kennedy
John Cassavetes -> Bob Balaban -> Elisabeth Shue
Jerry O'Connell -> Jim Haynie -> Cynthia Gibb
Robert Picardo -> Andrew McCarthy -> Estelle Getty
Kim Cattrall -> Andie MacDowell -> Imogen Stubbs
Mandy Patinkin -> Holly Hunter -> Brad Johnson
Ron Howard -> Paul Le Mat -> Charles Martin Smith
Jon Heder -> Danny Masterson -> Karl Malden
Maureen Stapleton -> Barbra Streisand -> Bob Feller
Brooks Robinson -> Earl Weaver -> Erica Leerhsen
Kurt Loder -> Stephen Barker Turner -> Michael T. Ringer
Petra Wright -> Gina Philips -> Colleen Werthmann
Timothy Wheeler -> Kevin Pinassi -> Chris Gartin
Jennifer Coolidge -> Oliver Hudson -> Keram Malicki-Sanchez
Emily Bergl -> Mia Kirshner -> Meredith Monroe
Marc Blucas -> Bijou Phillips -> Mischa Barton
Julie McCullough -> Erin O'Brien -> Jessica Morris
Adrian Paul -> Janice Karman -> Ross Bagdasarian Jr.
Zachary Levi -> Justin Long -> Sean Astin
Celia Weston -> Bruce Taylor -> Bob Odenkirk
Leon Lamar -> Zoe Axelrod -> Shelley Berman
Michael Chiklis -> Alexandra Tydings -> Jon Seda
Sheryl Lee -> Alan Smyth -> Sean Pertwee
David Heap -> JR Bourne -> Chyler Leigh
Tom Berenger -> Don Johnson -> Christina Ricci
Nick Swardson -> Connor Hill -> Angela Gots
Angela Little -> Zach McGowan -> Chandra West
Donna D'Errico -> Charles Dance -> Gary Farmer
Dan Wooster -> Mads Koudal -> Christopher Harrison
Doug Lennox -> David Hemblen -> James Allodi
Taylor Schilling -> Peter Mooney -> Jackson Robert Scott
Thom Haverstock -> Isabelle Mejias -> Tom McDonald
Pandora Richardson -> Shawn C. Phillips -> M. Kelley
Susie Duecker -> Richard O'Brien -> Jessica Harper
Gregory Peck -> Susan Tyrrell -> Robert F. Lyons
Sterling Hayden -> Craig Wasson -> Niall O'Brien
Country Joe and the Fish -> John Rubinstein -> Jordan Christopher
Eileen Heckart -> George Rose -> Isaac Delgado
Celia Cruz -> Willie Colon -> Emma Thompson
Rosa Isabel Lorenzo -> Abner Benaim -> Roberto Duran
Cheo Feliciano -> Tego Calderon -> Cultura Profetica
Miguel Sandoval -> Persia White -> Johnny Pacheco
Marc Anthony -> Yanfourd -> David Eisner
Rebecca Jenkins -> Stevie Vallance -> Sarah Lind
Kristine Cofsky -> Sonja Bennett -> Carmen Lavigne
Stephen Lobo -> Mike Dopud -> Brad Dryborough
Arabella Bushnell -> Ryan Robbins -> Richard Harmon
Craig Bierko -> Jaren Brandt Bartlett -> Carmen Tonry
Han Soto -> Zhener Wang -> Ziming Du
Griff Furst -> Yu Wang -> Alec Baldwin
Ken Murton -> Elizabeth Holder -> Jody Booth
Seregon O'Dassey -> Jaime Zevallos -> Franco Nero
Shane Perdue -> Matt Servitto -> Robert Mitchum
Bo Derek -> Jeff Fahey -> Chris Lemmon
Peter Scolari -> Everett Burrell -> Pasquale Buba
Peter Grunwald -> Samantha Mathis -> Patrick Fabian
Esai Morales -> Spanky Taylor -> Joyce Van Patten
Kate McNeil -> John Pankow -> Reg Jans
Julian Sands -> Pamela Salem -> John Hurt
Ricardo Palacios -> Gerardo Giacinti -> Penelope Cruz
Jero Garcia -> Richard Bohringer -> Richard Berry
Farid Chopel -> Marco Bellocchio -> Suso Cecchi D'Amico
Giuliano Gemma -> Klaus Maria Brandauer -> Stephen Boyd
Brigitte Bardot -> Anita Mally -> Christian Kohlund
Susanne Uhlen -> Vera Borek -> Toni Bohm
Rudolf Wessely -> Hans Kraus -> Helmuth Lohner
Eric P. Caspar -> Marlene Jobert -> Stefan Wigger
Zalman Lebiush -> Willy Leyrer -> Ellen Schwiers
Barbara Frey -> Katharina Mayberg -> Birgit Doll
Brent Fidler -> Richard Keats -> Mackenzie Gray
Danny Trejo -> Casey Manderson -> Paul Bae
Valerie Tian -> Dwayne Johnson -> Roland Moller
Haley Ramm -> Jonah Bobo -> Jason Bateman
Kevin Spacey -> Victor Garber -> Nicholas Hoult
Anita Gillette -> Ken Garito -> Austin Pendleton
Steven M. Gagnon -> Mac Davis -> Paul Land
Idina Menzel -> Suzanne Pred Bass -> Dennis Clancey
Leigh Benin -> Arnar Jonsson -> Matt O'Leary
Gunnar Helgason -> William Forsythe -> James Badge Dale
Ethan Embry -> Laura Harring -> Garrett Brawith
Peter Alsop -> Susan Angelo -> Kathy Najimy
Alaina Reed-Hall -> Lucy Goncalves -> Scott Robinson
Tichina Arnold -> Pierre Perea -> Senait Ashenafi
Antwan Mills -> N'Bushe Wright -> Christopher Amitrano
Graham Beckel -> Tara Buck -> Ram Dass
Max Casella -> Naomi Watts -> Bobby Cannavale
Caitlin Carmichael -> Garret Dillahunt -> Shea Whigham
Romeo Miller -> Gregg Sulkin -> Dallas Lovato
Dermot Mulroney -> Amy Price-Francis -> Ioan Gruffudd
Chandler Riggs -> Natalie Martinez -> Patrick Schwarzenegger
Quinn Shephard -> Rob Riggle -> Simone Labarga
Jessie T. Usher -> Will Brill -> Byron L. Hopkins
Shane Graham -> Lorenzo Richelmy -> Jenny Cooper
Kian Lawley -> Taylor John Smith -> Halston Sage
Nash Grier -> Gregory Alan Williams -> Edy Ganem
Lou Diamond Phillips -> Lloyd Bridges -> Ray Collins
Dan Dailey -> Billy Chapin -> Jay C. Flippen
Leo Gordon -> Scott Marlowe -> Billy Miller
Ronny Graham -> Julie Walters -> John Alderton
Om Puri -> Manish Dayal -> Charlotte Le Bon
Rupert Graves -> Keira Knightley -> Peter Jeffrey
Kaitlyn Bernard -> Dylan Schmid -> Molly Parker
Ron Perlman -> Gummaluri Sastri -> Sivamani
David O'Hara -> Dexter Fletcher -> Ralph Morgan
Etienne Girardot -> Robert Montgomery -> Reginald Owen
Helen Vinson -> Robert Benchley -> Franchot Tone
Myrna Loy -> Walter Pidgeon -> Brian Aherne
Jack Carson -> Alison Skipworth -> Paul Lukas
Donald Cook -> Betsy Blair -> Melvyn Douglas
Sid Caesar -> Ronald Colman -> Claudette Colbert
Victor McLaglen -> Willard Parker -> Alan Dinehart
Anna Massey -> Andrew Ray -> Glynis Johns
Noel Purcell -> Inia Te Wiata -> Alec Guinness
Anthony Steel -> Muriel Pavlow -> Richard Attenborough
Hugh Williams -> Corinne Calvet -> Diane Baker
Fred Clark -> Ed Wasser -> Grace Zabriskie
Tracy Nelson -> Patti Cohoon-Friedman -> Sam Hennings
Raymond Cruz -> Tony Dow -> Brad Dourif
Casey Kasem -> Russ Tamblyn -> Lana Wood
Joseph Schildkraut -> Shelley Winters -> Millie Perkins
Luciano Berriatua -> Adriano Apra -> Joao Benard da Costa
Michel Ciment -> Gian Piero Brunetta -> Michal Docolomansky
Vaclav Lohnisky -> Rudolf Hrusinsky -> Frantisek Filipovsky
Jaromir Hanzlik -> Libuse Safrankova -> Rudolf Deyl
Karel Fiala -> Kveta Fialova -> Daniela Kolarova
Karel Anderle -> Sandra Milo -> Marcello Mastroianni
Chris Marker -> Bob Castella -> Jean-Luc Godard
Reginald Kernan -> Alexandra Stewart -> Marcello Pagliero
Yvonne Lombard -> Gunnar Bjornstrand -> Eva Dahlbeck
Carl Lange -> Maria Sebaldt -> Helmut Griem
Herman Ahlsell -> Carl Billquist -> Gertrud Fridh
Alexander Skarsgard -> Ju-hee Park -> Robert Jelinek
Hyeon Ju -> Jin-mo Ju -> Min-sik Choi
Stefan Norrthon -> Do-yeon Jeon -> Mi-seon Hwang
Goran Cederberg -> Matti Oravisto -> Claude Titre
Douglas Hage -> Sven Lindberg -> Orson Welles
Sylva Koscina -> Laurence Harvey -> Mona Malm
Thomas Svanfeldt -> Zbigniew Cybulski -> Isa Quensel
Merilee Brasch -> Matt Marraccini -> Shannen Doherty
Josh Peck -> Camila Morrone -> Emily Blunt
Leanne Rowe -> Sonia Mbele -> Luthuli Dlamini
Tom Selleck -> Rachel Brennock -> Sean Barrett
Tony Aitken -> Maggie Wright -> Margaret Burton
Bartlett Mullins -> Kay Adrian -> Peggy Ann Clifford
George Buza -> Zoe De Grand Maison -> Rob Archer
Carl Bressler -> Eric McCormack -> Rafer Weigel
Allyson Ames -> Eloise Hardt -> Woody Strode
Lieux Dressler -> Tiffany Bolling -> Robert Charroux
Jeane Dixon -> Max H. Flindt -> Scott Rinker
Julianne Christie -> Harry Hamlin -> Daryn Tufts
Chris Clark -> Lisa Clark -> Malcolm McDowell
Robert Emhardt -> Beverly Lunsford -> Frank Maxwell
Colleen Dewhurst -> Bill Moseley -> Morena Baccarin
Trudy Marshall -> Charles Russell -> Douglass Dumbrille
Kay Scott -> Ann Doran -> Paul Kelly
Ben Cooper -> Colleen Miller -> Audie Murphy
Frank Ferguson -> Olga San Juan -> Mary Hatcher
Emily Browning -> Adam Horovitz -> Alyssa Maria App
Ashley Gerasimovich -> Danni Wang -> Vivian Wu
Lisa Lu -> Joe Lando -> Yanee Tramoth
Chantavit Dhanasevi -> Thawat Pornrattanaprasert -> Somlek Sakdikul
Patchara Buranawimolwan -> Saruth Chatchawan -> Mario Maurer
Nattapong Chartpong -> Davika Hoorne -> Nittha Jirayungyurn
Nuengthida Sophon -> Maneerat Kham-uan -> Siraphan Wattanajinda
Panissara Phimpru -> Rattanrat Eertaweekul -> Sirat Intarachote
Patcha Poonpiriya -> Preechaya Pongthananikorn -> Bonnie Zellerbach
Popetorn Soonthornyanakij -> Puttachat Pongsuchat -> Nalintip Permpattarasakul
Ananda Everingham -> Truong Ngoc Anh -> Andy On
Lily Ji -> Petar Bachvarov -> Zachary Baharov
Mimoza Bazova -> Dolph Lundgren -> Mariah Bonner
Jean-Claude Van Damme -> Takayuki Suzuki -> Yuri Morishita
Tomoko Kato -> Kiss Konishi -> Haruka Ayase
Todd Jensen -> Tsuyoshi Ihara -> David Essex
Sho Kosugi -> Christopher Lee -> Mithuna
Prajin -> Lakana Wattanawongsiri -> Phoomjai Tangsanga
Kett Thantup -> Chaleumpol Tikumpornteerawong -> Sura Theerakon
Sakrat Ruekthamrong -> Nat Tephadsadin Na Ayutthaya -> Chaiyapol Jullian Poupart
Ratklao Amaradit -> Sho Nishino -> Yayaying Rhatha Phongam
Bongkoj Khongmalai -> Petchtai Wongkamlao -> Sakaojai Poonsawat
Sulile Kumar -> Niveditha -> M.S. Bhaskar
Pongsak Pongsuwan -> Sarawut Phumthong -> Note Chern-Yim
Apichej Kittikornjaroen -> Supatchaya Reunreung -> Dan Worrawech
Pisamai Wilaisak -> Kom Chauncheun -> Khwannapa Reuangsri
Visa Sarasas -> Somphong Kunapratom -> Kohtee Aramboy
Duangrudee Boonbumroong -> Cheathavuth Watcharakhun -> Anant Boonnark
Paula Taylor -> Somchai Samipak -> Christian Lee
Celeste Lim -> Cindy Ng -> Garrett Hoo
Ray MacDonald -> Athip Nana -> Choomporn Theppitak
Thiti Phum-Orn -> Al Ameen Saeleema -> Sorapong Chatree
Po Pao Pee -> Artit Wiboonpanitch -> Arpa Pawilai
Boonyisa Jantrarachai -> Sarunyu Prachakrit -> Chanana Nutakom
Narubet Jinpinpetch -> Paweena Chariffsakul -> Naiyana Maneetes
Anchalee Chaisiri -> Pumwaree Yodkamol -> Tony Jaa
Channarong Khuntee-tao -> Somjai Sukjai -> Sonthaya Chitmanee
Hiroyuki Kobayashi -> Surachai Chantimatorn -> Yasuhiko Miyauchi
Oranate D. Caballes -> Nitit Warayanon -> Nadech Kugimiya
Julaluck Ismalone -> Don Ferguson -> James B. Harris
David Spodak -> Kirk Douglas -> Edward Asner
Jorge Ameer -> Lance Alspaugh -> Rosalie Michaels
Cavin Gray -> Shane Dean -> Aundre Caraway
Stan Babola -> Lawrence Hervey -> Lauri Hendler
Judy Norton -> Colin Bird -> Lee Majors
Stefanie Powers -> Helynn Castro -> Christopher Studenka
Morgan Jacobs -> Tori Osborn -> Lori Petty
Michael Boatman -> Erich Anderson -> Kaine Alozie
Buzz Aldrin -> Andrew Alozie -> Leland Burnett
Dane Reade -> Brenda Galilee Rhodes -> Joe Perrino
Caprice Benedetti -> Rhiann Woodyard -> Joy Michele
Robby Daniels -> Jeffrey Lee Hollis -> Ray Hanna
Patrick Pumpuang -> John Fraser -> Anthony Quayle
Donald Houston -> Gil Bellows -> Parker Posey
Kevin McDonald -> Benjamin Ratner -> Elizabeth Berkley
Jay Brazeau -> Phyllis Calvert -> Ralph Richardson
Robert Morley -> Patrick Newell -> Philip Stone
Gabriella Licudi -> Leslie Hope -> Alberto Tejada
Carlos Roberto Majul -> Ana Sobero -> Aramis Knight
Melissa Benoist -> Greg Germann -> Melinda Hall
Bob Burns -> Jennifer Blaire -> Larry Blamire
Ray Appleton -> Mackenzie Astin -> Izabella Miko
Jeremy Piven -> Nick Cassavetes -> Brenda Bakke
Curtis Armstrong -> Ran Barker -> Wendy Baker
Tony Amendola -> Jenna Bailey -> James Black
Shelley Andagan -> Mel Braxton -> Bre Blair
Elizabeth Lesser -> Jennifer Turner -> Ayden Clay
Andra Eggleston -> Maud Schuyler Clay -> Bernie Worrell
Alex Weir -> Steven Scales -> Michael Beckwith
Julia Decker -> Shohreh Aghdashloo -> Denise Brown
Russell Simmons -> Anthony Holds -> Greg Hansen
John Jenis -> Daniel Passaro -> Noam Chomsky
Douglas Rushkoff -> Laurie Williams -> Karamea Davis
Miranda Adams -> Keith Stewart -> Kate Bush
Joan Armatrading -> Chet Atkins -> 
